Player,GP,G,A,TP,PPG,PIM,POS,firstYear,lastYear
Wayne Gretzky,1487,894,1963,2857,1.921,577,C,1979,1999
Jaromir Jagr,1733,766,1155,1921,1.1079999999999999,1167,RW,1990,2018
Mark Messier,1756,694,1193,1887,1.075,1910,C,1979,2004
Gordie Howe,1767,801,1049,1850,1.047,1685,RW,1946,1980
Ron Francis,1731,549,1249,1798,1.0390000000000001,979,C,1981,2004
Marcel Dionne,1348,731,1040,1771,1.314,600,C,1971,1989
Steve Yzerman,1514,692,1063,1755,1.159,924,C,1983,2006
Mario Lemieux,915,690,1033,1723,1.883,834,C,1984,2006
Joe Sakic,1378,625,1016,1641,1.1909999999999998,614,C,1988,2009
Phil Esposito,1282,717,873,1590,1.24,910,C,1963,1981
Raymond Bourque,1612,410,1169,1579,0.98,1141,D,1979,2001
Mark Recchi,1652,577,956,1533,0.9279999999999999,1033,RW,1988,2011
Paul Coffey,1409,396,1135,1531,1.087,1802,D,1980,2001
Joe Thornton,1641,421,1090,1511,0.9209999999999999,1250,C,1997,2021
Stan Mikita,1394,541,926,1467,1.052,1270,C,1958,1980
Teemu Selanne,1451,684,773,1457,1.004,660,RW,1992,2014
Bryan Trottier,1279,524,901,1425,1.114,912,C,1975,1994
Adam Oates,1337,341,1079,1420,1.062,415,C,1985,2004
Doug Gilmour,1474,450,964,1414,0.9590000000000001,1299,C,1983,2003
Dale Hawerchuk,1188,518,891,1409,1.186,740,C,1981,1997
Jari Kurri,1251,601,797,1398,1.1179999999999999,545,RW,1980,1998
Luc Robitaille,1431,668,726,1394,0.9740000000000001,1177,LW,1986,2006
Brett Hull,1269,741,650,1391,1.0959999999999999,457,RW,1985,2006
Mike Modano,1499,561,813,1374,0.917,926,C,1988,2011
Johnny Bucyk,1540,556,813,1369,0.889,497,LW,1955,1978
Brendan Shanahan,1524,656,698,1354,0.888,2489,LW,1987,2009
Guy Lafleur,1126,560,793,1353,1.202,399,RW,1971,1991
Mats Sundin,1346,564,785,1349,1.002,1093,C,1990,2009
Dave Andreychuk,1639,640,698,1338,0.816,1121,LW,1982,2006
Denis Savard,1196,473,865,1338,1.119,1336,C,1980,1997
Mike Gartner,1432,708,627,1335,0.932,1159,RW,1979,1998
Pierre Turgeon,1294,515,812,1327,1.026,452,C,1987,2007
Gilbert Perreault,1191,512,814,1326,1.113,500,C,1970,1987
Jarome Iginla,1554,625,675,1300,0.8370000000000001,1040,RW,1995,2017
Alexander Ovechkin,1156,707,576,1283,1.11,719,LW,2005,2021
Alex Delvecchio,1550,456,825,1281,0.826,383,C,1950,1974
Al MacInnis,1416,340,934,1274,0.9,1511,D,1981,2004
Sidney Crosby,989,465,803,1268,1.2819999999999998,677,C,2005,2021
Jean Ratelle,1281,491,776,1267,0.9890000000000001,276,C,1960,1981
Peter Stastny,977,450,789,1239,1.268,824,C,1980,1995
Phil Housley,1495,338,894,1232,0.8240000000000001,822,D,1982,2003
Norm Ullman,1410,490,739,1229,0.872,712,C,1955,1975
Jean Beliveau,1125,507,712,1219,1.084,1029,C,1950,1971
Jeremy Roenick,1363,513,703,1216,0.892,1463,C,1988,2009
Larry Murphy,1615,287,929,1216,0.753,1084,D,1980,2001
Bobby Clarke,1144,358,852,1210,1.058,1453,C,1969,1984
Bernie Nicholls,1127,475,734,1209,1.073,1292,C,1981,1999
Vincent Damphousse,1378,432,783,1205,0.8740000000000001,1190,C,1986,2004
Dino Ciccarelli,1232,608,592,1200,0.9740000000000001,1425,RW,1980,1999
Patrick Marleau,1728,562,627,1189,0.688,517,LW,1997,2021
Rod Brind'Amour,1484,452,732,1184,0.7979999999999999,1100,C,1988,2010
Sergei Fedorov,1248,483,696,1179,0.945,839,C,1990,2009
Bobby Hull,1063,610,560,1170,1.101,640,LW,1957,1980
Daniel Alfredsson,1246,444,713,1157,0.929,510,RW,1995,2014
Michel Goulet,1089,548,604,1152,1.058,825,LW,1979,1994
Nicklas Lidstrom,1564,264,878,1142,0.73,514,D,1991,2012
Marian Hossa,1309,525,609,1134,0.866,628,RW,1997,2021
Bernie Federko,1000,369,761,1130,1.13,487,C,1976,1990
Mike Bossy,752,573,553,1126,1.4969999999999999,222,RW,1977,1987
Joe Nieuwendyk,1257,564,562,1126,0.8959999999999999,677,C,1986,2007
Darryl Sittler,1096,484,637,1121,1.023,948,C,1970,1985
Frank Mahovlich,1181,533,570,1103,0.934,1056,LW,1956,1974
Glenn Anderson,1129,498,601,1099,0.973,1120,RW,1980,1996
Theo Fleury,1084,455,633,1088,1.004,1840,RW,1988,2003
Yevgeni Malkin,912,417,661,1078,1.182,960,C,2006,2021
Henrik Sedin,1330,240,830,1070,0.805,680,C,2000,2018
Dave Taylor,1111,431,638,1069,0.9620000000000001,1589,RW,1977,1994
Keith Tkachuk,1201,538,527,1065,0.887,2219,LW,1991,2010
Ray Whitney,1330,385,679,1064,0.8,465,LW,1991,2014
Pat Verbeek,1424,521,541,1063,0.746,2905,RW,1982,2002
Joe Mullen,1062,502,561,1063,1.001,241,RW,1979,1997
Denis Potvin,1060,310,742,1052,0.992,1356,D,1973,1988
Henri Richard,1256,358,688,1046,0.833,928,C,1955,1975
Daniel Sedin,1306,393,648,1041,0.797,546,LW,2000,2018
Bobby Smith,1077,357,679,1036,0.9620000000000001,917,C,1978,1993
Martin St. Louis,1134,391,642,1033,0.9109999999999999,310,RW,1998,2015
Doug Weight,1238,278,755,1033,0.8340000000000001,970,C,1990,2011
Alexander Mogilny,990,473,559,1032,1.042,432,RW,1989,2006
Alexei Kovalev,1316,430,599,1029,0.782,1304,RW,1992,2013
Brian Leetch,1205,247,781,1028,0.853,571,D,1987,2006
Patrick Kane,978,392,635,1027,1.05,380,RW,2007,2021
Patrik Elias,1240,408,617,1025,0.8270000000000001,549,LW,1995,2016
Eric Staal,1245,437,586,1023,0.8220000000000001,818,C,2003,2021
Brian Bellows,1188,485,537,1022,0.86,718,RW,1982,1999
Rod Gilbert,1065,406,615,1021,0.9590000000000001,508,RW,1960,1978
Dale Hunter,1409,323,697,1020,0.7240000000000001,3565,RW,1980,1999
Pat LaFontaine,865,468,545,1013,1.171,552,C,1983,1998
Steve Larmer,1006,441,571,1012,1.006,532,RW,1980,1995
Lanny McDonald,1111,500,506,1006,0.905,899,RW,1973,1989
Brian Propp,1016,425,579,1004,0.988,830,LW,1979,1994
Paul Kariya,989,402,587,989,1.0,399,LW,1994,2010
Rick Middleton,1005,448,540,988,0.983,157,RW,1974,1988
Dave Keon,1296,396,590,986,0.7609999999999999,117,C,1960,1982
Andy Bathgate,1069,349,624,973,0.91,624,C/RW,1952,1971
Shane Doan,1540,402,570,972,0.631,1353,RW,1995,2017
Ryan Getzlaf,1058,274,693,967,0.914,892,C,2005,2021
Maurice Richard,978,544,422,966,0.988,1285,RW,1942,1960
Henrik Zetterberg,1082,337,623,960,0.887,401,C,2002,2021
Kirk Muller,1349,357,602,959,0.711,1223,C,1984,2003
Larry Robinson,1384,208,750,958,0.6920000000000001,793,D,1972,1992
Anze Kopitar,1077,333,623,956,0.888,296,C,2006,2021
Rick Tocchet,1144,440,512,952,0.8320000000000001,2912,RW,1984,2002
Vincent Lecavalier,1212,421,528,949,0.7829999999999999,848,C,1998,2016
Chris Chelios,1651,185,763,948,0.574,2891,D,1983,2010
Jason Spezza,1129,341,601,942,0.8340000000000001,576,C,2002,2021
Jason Arnott,1244,417,521,938,0.754,1242,C,1993,2012
Steve Thomas,1235,421,512,933,0.755,1306,RW,1984,2004
Brad Richards,1126,298,634,932,0.828,251,C,2000,2016
Nicklas Backstrom,961,246,686,932,0.97,462,C,2007,2021
Neal Broten,1099,289,634,923,0.84,569,C,1980,1997
Pavel Datsyuk,953,314,604,918,0.963,232,C,2001,2016
Bobby Orr,657,270,645,915,1.393,953,D,1966,1979
Gary Roberts,1225,438,472,910,0.743,2560,LW,1986,2009
Scott Stevens,1635,196,712,908,0.555,2785,D,1982,2004
Tony Amonte,1174,416,484,900,0.767,752,RW,1990,2007
Ray Ferraro,1258,408,490,898,0.7140000000000001,1288,C,1984,2002
Brad Park,1113,213,683,896,0.805,1429,D,1968,1985
Peter Bondra,1081,503,389,892,0.825,761,RW,1990,2007
Butch Goring,1107,375,513,888,0.802,102,C,1969,1985
Owen Nolan,1200,422,463,885,0.738,1793,RW,1990,2010
Peter Forsberg,708,249,636,885,1.25,688,C,1994,2011
Bill Barber,903,420,463,883,0.978,623,LW,1972,1984
Dennis Maruk,888,356,522,878,0.9890000000000001,761,C,1975,1989
Ilya Kovalchuk,926,443,433,876,0.946,544,LW/RW,2001,2020
Patrice Bergeron,1093,353,519,872,0.7979999999999999,424,C,2003,2021
Markus Naslund,1117,395,474,869,0.778,736,LW,1993,2009
Cliff Ronning,1137,306,563,869,0.764,453,C,1985,2004
Trevor Linden,1372,375,492,867,0.632,895,C,1988,2008
Ivan Boldirev,1052,361,505,866,0.823,507,C,1970,1985
Phil Kessel,1071,375,490,865,0.8079999999999999,320,RW,2006,2021
Eric Lindros,760,372,493,865,1.138,1398,C,1992,2007
Yvan Cournoyer,968,428,435,863,0.892,255,RW,1963,1979
Alex Tanguay,1088,283,580,863,0.7929999999999999,527,LW,1999,2016
Dean Prentice,1378,391,469,860,0.624,484,LW,1952,1974
Tomas Sandstrom,983,394,463,857,0.872,1193,RW,1984,1999
Bill Guerin,1263,429,427,856,0.6779999999999999,1660,RW,1991,2010
Vyacheslav Kozlov,1182,356,497,853,0.722,704,LW,1991,2010
Ted Lindsay,1068,379,472,851,0.797,1808,LW,1944,1965
Gary Suter,1145,203,641,844,0.737,1349,D,1985,2002
Tom Lysiak,919,292,551,843,0.917,567,C,1973,1986
John MacLean,1194,413,429,842,0.705,1328,RW,1983,2002
Ryan Smyth,1270,386,456,842,0.6629999999999999,976,LW,1994,2014
Scott Mellanby,1431,364,476,840,0.5870000000000001,2479,RW,1985,2007
Steven Stamkos,806,424,414,838,1.04,499,C/W,2008,2021
John Tonelli,1028,325,511,836,0.813,911,LW,1978,1992
Jacques Lemaire,853,366,469,835,0.9790000000000001,217,C,1967,1979
Saku Koivu,1124,255,577,832,0.74,809,C,1995,2014
Brent Sutter,1111,363,466,829,0.746,1054,C,1980,1998
John Ogrodnick,928,402,425,827,0.8909999999999999,260,LW,1979,1993
Doug Wilson,1024,237,590,827,0.8079999999999999,830,D,1977,1993
Red Kelly,1316,281,542,823,0.625,327,D/C,1947,1967
Pierre Larouche,812,395,427,822,1.012,237,C,1974,1988
Bernard Geoffrion,883,393,429,822,0.9309999999999999,689,RW,1950,1968
Stephane Richer,1054,421,398,819,0.777,614,LW,1984,2002
John LeClair,967,406,413,819,0.847,501,LW,1990,2007
Claude Giroux,895,257,562,819,0.915,382,C/W,2007,2021
Steve Shutt,930,424,393,817,0.878,410,LW,1972,1985
Thomas Steen,950,264,553,817,0.86,753,C,1981,1995
Marian Gaborik,1035,407,408,815,0.787,492,RW/LW,2000,2021
Jonathan Toews,943,345,470,815,0.8640000000000001,525,C,2007,2021
Wilf Paiement,946,356,458,814,0.86,1757,RW,1974,1988
Peter McNab,954,363,450,813,0.852,179,C,1973,1987
Sergei Gonchar,1301,220,591,811,0.623,981,D,1994,2015
Pit Martin,1101,324,485,809,0.735,609,C,1961,1979
Ken Linseman,860,256,551,807,0.938,1727,LW,1978,1992
Rick Nash,1060,437,368,805,0.759,750,LW/RW,2002,2018
Milan Hejduk,1020,375,430,805,0.789,316,RW,1998,2013
Garry Unger,1105,413,391,804,0.728,1075,C,1967,1983
Ken Hodge,881,328,472,800,0.9079999999999999,779,RW,1964,1978
Geoff Courtnall,1049,367,432,799,0.762,1465,LW,1983,2000
Corey Perry,1045,377,420,797,0.763,1180,RW,2005,2021
Justin Williams,1264,320,477,797,0.631,766,RW,2000,2020
Joe Pavelski,1031,371,425,796,0.772,400,C/RW,2006,2021
Ed Olczyk,1031,342,452,794,0.77,874,C,1984,2000
Zach Parise,1020,387,406,793,0.777,380,LW/RW,2005,2021
Wayne Cashman,1027,277,516,793,0.772,1041,RW,1964,1983
Mike Ribeiro,1074,228,565,793,0.738,577,C,1999,2017
Dany Heatley,869,372,419,791,0.91,620,LW/RW,2001,2015
Thomas Vanek,1029,373,416,789,0.767,547,LW/RW,2005,2019
Rick Vaive,876,441,347,788,0.9,1445,RW,1979,1992
Borje Salming,1148,150,637,787,0.6859999999999999,1344,D,1973,1990
Claude Lemieux,1215,369,407,786,0.647,1777,RW,1983,2009
Alexei Yashin,850,337,444,781,0.919,401,C,1993,2007
Pavel Bure,702,437,342,779,1.11,484,RW,1991,2003
Rob Blake,1270,240,537,777,0.612,1679,D,1989,2010
John Tavares,820,349,427,776,0.946,367,C,2009,2021
Jean Pronovost,998,391,383,774,0.7759999999999999,413,RW,1968,1982
Dave Christian,1009,340,433,773,0.7659999999999999,284,RW,1979,1994
Pete Mahovlich,884,288,485,773,0.8740000000000001,916,LW,1965,1981
Sergei Zubov,1068,152,619,771,0.722,337,D,1992,2009
Todd Bertuzzi,1159,314,456,770,0.664,1478,RW,1995,2014
Pavol Demitra,848,304,464,768,0.9059999999999999,284,C,1993,2010
Rick Kehoe,906,371,396,767,0.847,120,RW,1971,1985
Blake Wheeler,935,266,499,765,0.818,615,RW/C,2008,2021
Vaclav Prospal,1108,255,510,765,0.69,581,LW/C,1996,2013
Brian Rolston,1256,342,419,761,0.606,472,LW,1994,2012
Kevin Dineen,1188,355,405,760,0.64,2229,RW,1984,2003
Rick MacLeish,846,349,410,759,0.897,434,LW,1970,1984
Murray Craven,1071,266,493,759,0.7090000000000001,524,C,1982,2000
Mike Ridley,866,292,466,758,0.875,424,C,1985,1997
Scott Young,1181,342,415,757,0.6409999999999999,448,RW,1987,2006
Scott Gomez,1079,181,575,756,0.701,655,C,1999,2016
Steve Duchesne,1113,227,526,752,0.6759999999999999,824,D,1986,2002
Craig Janney,760,188,563,751,0.988,170,C,1987,1999
Olli Jokinen,1231,321,429,750,0.609,1071,C,1997,2015
Bobby Holik,1314,326,421,747,0.568,1421,C,1990,2009
Steve Sullivan,1011,290,457,747,0.7390000000000001,587,LW,1995,2013
Russ Courtnall,1029,297,447,744,0.723,557,RW,1983,1999
Mathieu Schneider,1289,223,521,744,0.5770000000000001,1250,D,1987,2010
Greg Adams,1056,355,388,743,0.7040000000000001,326,LW,1984,2001
Mark Howe,929,197,545,742,0.799,455,D,1979,1995
Scott Niedermayer,1263,172,574,740,0.586,784,D,1991,2010
Jeff Carter,1044,383,354,737,0.706,537,C,2005,2021
Miroslav Satan,1050,363,372,735,0.7,464,RW,1995,2010
Andrew Brunette,1109,268,465,733,0.6609999999999999,314,LW,1995,2012
Andrew Cassels,1015,204,528,732,0.721,410,C,1989,2006
Matt Cullen,1516,266,465,731,0.48200000000000004,592,C,1997,2019
Bobby Carpenter,1178,320,408,728,0.618,919,C,1981,1999
Murray Oliver,1127,274,454,728,0.6459999999999999,320,C,1957,1975
Mike Foligno,1018,355,372,727,0.7140000000000001,2045,RW,1979,1994
Jason Pominville,1060,293,434,727,0.6859999999999999,199,RW,2003,2019
Cory Stillman,1025,278,449,727,0.7090000000000001,489,LW,1994,2011
Kevin Stevens,874,329,397,726,0.831,1470,LW,1987,2002
Bob Nevin,1128,307,419,726,0.644,211,RW,1957,1976
Paul Stastny,949,250,476,726,0.765,438,C,2006,2021
Dave Babych,1194,142,581,723,0.606,970,D,1980,1999
Petr Sykora,1017,323,398,721,0.7090000000000001,433,RW,1995,2012
Dave Gagner,946,318,401,719,0.76,1016,C,1984,1999
Alexei Zhamnov,807,249,470,719,0.8909999999999999,668,C,1992,2006
Petr Nedved,982,310,407,717,0.73,708,C,1990,2007
Martin Straka,954,257,460,717,0.752,360,C,1992,2008
Zigmund Palffy,684,329,384,713,1.042,322,RW,1993,2006
George Armstrong,1187,296,417,713,0.601,721,C,1949,1971
Vic Hadfield,1002,323,389,712,0.711,1154,LW,1961,1977
Charlie Simmer,712,342,369,711,0.9990000000000001,544,LW,1974,1988
Doug Mohns,1390,248,462,710,0.511,1250,LW/D,1953,1975
Mikko Koivu,1028,205,504,709,0.69,592,C,2005,2021
Scott Hartnell,1249,327,380,707,0.5660000000000001,1809,LW,2000,2018
Marc Savard,807,207,499,706,0.875,737,C,1997,2017
Robert Lang,989,261,442,703,0.711,424,C,1992,2010
Bobby Rousseau,942,245,458,703,0.746,359,RW,1960,1975
Rene Robert,744,284,418,702,0.9440000000000001,597,C,1970,1982
Rick Martin,685,384,317,701,1.023,477,LW,1971,1982
Mel Bridgman,977,252,449,701,0.718,1625,C,1975,1989
Jakub Voracek,920,208,493,701,0.762,467,RW/LW,2008,2021
Geoff Sanderson,1104,355,345,700,0.634,511,LW,1990,2008
Chris Pronger,1167,157,541,698,0.598,1590,D,1993,2012
Clark Gillies,958,319,378,697,0.728,1023,LW,1974,1988
Brent Burns,1118,211,486,697,0.623,691,D,2003,2021
Daniel Briere,973,307,389,696,0.715,744,C,1997,2015
Cam Neely,726,395,299,694,0.956,1241,RW,1983,1996
Mike Bullard,755,336,358,694,0.919,741,LW,1980,1992
Shayne Corson,1156,273,420,693,0.599,2357,LW,1985,2004
David Krejci,915,207,482,689,0.753,327,C,2006,2021
Jamie Benn,815,300,388,688,0.8440000000000001,615,LW,2009,2021
Kent Nilsson,553,264,422,686,1.2409999999999999,116,C,1979,1995
Danny Gare,827,354,331,685,0.828,1285,RW,1974,1987
Dan Quinn,805,266,419,685,0.851,533,C,1983,1997
Reed Larson,904,222,463,685,0.758,1391,D,1976,1990
Don Lever,1020,313,367,680,0.667,593,LW,1972,1987
Michael Nylander,920,209,470,679,0.738,468,C,1992,2009
Walt Tkaczuk,945,227,451,678,0.7170000000000001,556,C,1967,1981
Kevin Hatcher,1157,227,450,677,0.585,1392,D,1984,2001
Jozef Stumpel,957,196,481,677,0.7070000000000001,245,C,1991,2008
Tim Kerr,655,370,304,674,1.0290000000000001,596,RW,1980,1993
Phil Goyette,941,207,467,674,0.716,131,C,1956,1972
Paul MacLean,719,324,349,673,0.9359999999999999,968,RW,1980,1991
Stan Smyl,898,262,411,673,0.7490000000000001,1556,RW,1978,1991
Daymond Langkow,1090,270,402,672,0.617,547,C,1995,2012
Craig Ramsay,1070,252,420,672,0.628,201,LW,1971,1985
Reggie Leach,934,381,285,666,0.713,387,RW,1970,1983
Guy Carbonneau,1318,260,403,663,0.503,820,C,1980,2000
Jamie Langenbrunner,1109,243,420,663,0.598,837,RW,1994,2013
Martin Gelinas,1273,308,351,659,0.518,820,LW,1988,2008
Red Berenson,987,261,397,658,0.667,305,LW,1961,1978
Kelly Kisio,761,229,429,658,0.865,768,C,1982,1995
Ray Sheppard,817,357,300,657,0.804,212,RW,1987,2000
Zdeno Chara,1558,205,452,657,0.42200000000000004,1958,D,1997,2021
Ulf Dahlen,966,301,354,655,0.6779999999999999,230,RW,1987,2003
Dustin Brown,1187,300,355,655,0.552,706,RW/LW,2003,2021
Dennis Hull,959,303,351,654,0.682,261,LW,1964,1978
Barry Pederson,701,238,416,654,0.9329999999999999,472,C,1980,1992
Glen Murray,1009,337,314,651,0.645,679,RW,1991,2008
Bryan Smolinski,1055,274,377,651,0.617,606,C,1992,2008
Brad Marchand,755,291,359,650,0.861,758,LW,2009,2021
Randy Carlyle,1055,148,499,647,0.613,1400,D,1976,1993
Ryan Walter,1003,264,382,646,0.644,946,C,1978,1993
Igor Larionov,921,169,475,644,0.6990000000000001,474,C,1989,2004
Bob Pulford,1079,281,362,643,0.596,792,LW,1956,1972
Michael Cammalleri,906,294,348,642,0.7090000000000001,425,W/C,2002,2018
Ron Ellis,1034,332,308,640,0.619,207,RW,1963,1981
Tony McKegney,912,320,319,639,0.701,517,LW,1978,1991
Ralph Backstrom,1032,278,361,639,0.619,386,C,1956,1973
James Patrick,1280,149,490,639,0.499,759,D,1983,2004
Roman Hamrlik,1395,155,483,638,0.457,1408,D,1992,2013
Teppo Numminen,1372,117,520,637,0.46399999999999997,513,D,1988,2009
Brian Sutter,779,303,333,636,0.816,1786,LW,1976,1988
Anton Stastny,650,252,384,636,0.978,150,LW,1980,1989
Tyler Seguin,741,279,356,635,0.857,223,C/RW,2010,2021
Mats Naslund,651,251,383,634,0.9740000000000001,111,LW,1982,1995
John Anderson,814,282,349,631,0.775,263,LW,1977,1989
Robert Reichel,830,252,378,630,0.759,388,C,1990,2004
Esa Tikkanen,877,244,385,630,0.718,1077,LW,1984,1999
Brent Ashton,998,284,345,629,0.63,635,C/LW,1979,1993
Ed Westfall,1226,231,394,625,0.51,544,RW,1961,1979
Radim Vrbata,1057,284,339,623,0.589,294,RW,2001,2018
Elmer Lach,664,215,408,623,0.938,478,C,1940,1954
Brian Mullen,832,255,362,622,0.748,414,LW,1982,1993
Alexander Steen,1018,245,377,622,0.611,454,LW/RW,2005,2021
Guy Lapointe,884,171,451,622,0.7040000000000001,893,D,1968,1984
Patrick Sharp,939,287,333,620,0.66,536,LW/RW,2002,2018
Ron Duguay,864,274,346,620,0.718,582,C,1977,1989
Chris Kunitz,1022,268,351,619,0.606,746,LW,2003,2019
Keith Primeau,909,266,353,619,0.6809999999999999,1541,C,1990,2006
David Legwand,1136,228,390,618,0.544,551,C,1998,2016
Adam Graves,1152,329,287,616,0.535,1224,LW,1987,2003
Fred Stanfield,914,211,405,616,0.674,134,LW,1964,1978
Chris Drury,892,260,355,615,0.6890000000000001,468,C,1998,2011
Duncan Keith,1143,101,513,614,0.537,631,D,2005,2021
Derek King,830,261,351,612,0.737,417,LW,1986,2000
Martin Rucinsky,961,241,371,612,0.637,821,LW,1991,2008
Ron Greschner,982,179,431,610,0.621,1226,D,1974,1990
Dickie Moore,719,261,347,608,0.846,652,LW,1951,1968
Tomas Plekanec,1001,233,375,608,0.607,543,C,2003,2019
Peter Zezel,873,219,389,608,0.696,435,C,1984,1999
Walt McKechnie,955,214,392,606,0.635,469,C,1967,1983
Terry O'Reilly,891,204,402,606,0.68,2095,RW,1971,1985
"Syl Apps, Jr.",727,183,423,606,0.8340000000000001,311,C,1970,1980
Mike Ricci,1099,243,362,605,0.551,974,C,1990,2007
Dan Boyle,1093,163,442,605,0.5539999999999999,693,D,1998,2016
Erik Karlsson,741,135,470,605,0.816,354,D,2009,2021
Bert Olmstead,848,181,421,602,0.71,884,LW,1948,1962
Simon Gagne,822,291,310,601,0.731,328,LW,1999,2015
Brendan Morrison,934,200,401,601,0.643,450,C,1997,2012
Garry Galley,1149,125,475,600,0.522,1218,D,1984,2001
Michal Pivonka,825,181,418,599,0.726,478,C,1986,1999
Stu Barnes,1136,261,336,597,0.526,438,C,1991,2008
Dmitri Khristich,811,259,338,597,0.736,422,RW,1990,2002
Brian Gionta,1026,291,304,595,0.58,377,RW,2001,2018
Martin Havlat,790,242,352,594,0.752,404,RW/LW,2000,2016
Jean-Paul Parise,890,238,356,594,0.667,706,LW,1965,1979
Loui Eriksson,968,250,343,593,0.613,192,LW/RW,2006,2021
Thomas Gradin,677,209,384,593,0.8759999999999999,298,C,1978,1987
Matt Duchene,797,245,346,591,0.742,192,C,2009,2021
Al MacAdam,864,240,351,591,0.684,509,RW,1973,1985
Dainius Zubrus,1293,228,363,591,0.457,791,W/C,1996,2016
Ryan Suter,1147,90,501,591,0.515,655,D,2005,2021
Radek Dvorak,1260,227,363,590,0.46799999999999997,449,RW,1995,2014
Mike Fisher,1104,278,311,589,0.534,815,C,1999,2018
Don Marshall,1176,265,324,589,0.501,127,LW,1951,1972
Claude Provost,1005,254,335,589,0.586,469,RW,1955,1970
Patrik Sundstrom,676,219,369,588,0.87,349,RW,1982,1992
Carol Vadnais,1087,169,418,587,0.54,1813,D,1966,1983
Steve Vickers,698,246,340,586,0.84,330,LW,1972,1982
Jeff Brown,747,154,431,585,0.7829999999999999,498,D,1985,1998
Mario Tremblay,852,258,326,584,0.685,1043,RW,1974,1986
Troy Murray,915,230,354,584,0.638,875,C,1981,1996
Keith Acton,1023,226,358,584,0.5710000000000001,1172,C,1979,1994
Bob Bourne,964,258,324,582,0.604,605,C,1974,1988
Don McKenney,798,237,345,582,0.7290000000000001,211,C,1954,1968
Tom Fergus,726,235,346,581,0.8,499,C,1981,1993
Fredrik Olausson,1022,147,434,581,0.568,450,D,1986,2003
Shawn McEachern,911,256,323,579,0.636,506,LW,1991,2006
Laurie Boschman,1009,229,348,577,0.5720000000000001,2265,C,1979,1993
Robert MacMillan,753,228,349,577,0.7659999999999999,260,RW,1974,1985
Keith Yandle,978,100,476,576,0.589,566,D,2006,2021
Brenden Morrow,991,265,310,575,0.58,1362,LW,1999,2015
Milt Schmidt,776,229,346,575,0.741,466,C,1936,1955
Guy Chouinard,578,205,370,575,0.995,120,C,1974,1984
Eric Desjardins,1143,136,439,575,0.503,757,D,1988,2006
Eric Nesterenko,1219,250,324,574,0.47100000000000003,1273,RW,1951,1972
Shea Weber,995,219,355,574,0.5770000000000001,687,D,2005,2021
Petr Klima,786,313,260,573,0.7290000000000001,671,RW,1985,1999
Jim Pappin,767,278,295,573,0.747,667,RW,1963,1977
Ryan Kesler,1001,258,315,573,0.5720000000000001,920,C,2003,2021
Dick Duff,1030,283,289,572,0.555,743,LW,1954,1972
Ales Hemsky,845,174,398,572,0.677,353,RW,2002,2018
Joe Juneau,828,156,416,572,0.691,271,C,1991,2004
Andrei Markov,990,119,453,572,0.578,505,D,2000,2017
T.J. Oshie,808,238,333,571,0.7070000000000001,410,RW,2008,2021
Sergei Samsonov,888,235,336,571,0.643,209,LW,1997,2011
Kimmo Timonen,1108,117,454,571,0.515,654,D,1998,2015
Mike Krushelnyski,897,241,328,569,0.634,699,C,1981,1995
Taylor Hall,632,219,350,569,0.9,350,LW,2010,2021
Chris Gratton,1092,214,354,568,0.52,1638,C,1993,2009
Dave Ellett,1129,153,415,568,0.503,985,D,1984,2000
Bill Gadsby,1248,130,438,568,0.455,1539,D,1946,1966
Ross Lonsberry,968,256,310,566,0.585,806,LW,1966,1981
Wendel Clark,793,330,234,564,0.711,1690,LW,1985,2000
Don Maloney,765,214,350,564,0.737,815,LW,1978,1991
Sandis Ozolins,875,167,397,564,0.645,638,D,1992,2008
Rob Ramage,1044,139,425,564,0.54,2224,D,1979,1994
Jussi Jokinen,951,191,372,563,0.5920000000000001,377,W/C,2005,2018
Tomas Kaberle,984,87,476,563,0.5720000000000001,260,D,1998,2013
Jimmy Carson,626,275,286,561,0.8959999999999999,254,C,1986,1996
Ryan O'Reilly,808,195,366,561,0.6940000000000001,110,C,2009,2021
Tony Tanti,697,287,273,560,0.8029999999999999,661,LW,1981,1992
Ted Kennedy,696,231,329,560,0.805,432,C,1942,1957
Bobby Ryan,837,258,301,559,0.6679999999999999,460,RW/LW,2007,2021
Paul Reinhart,648,133,426,559,0.863,277,D,1979,1990
Max Pacioretty,768,283,275,558,0.727,421,LW,2008,2021
"Billy Harris, Jr.",897,231,327,558,0.622,394,RW,1972,1984
Bobby Schmautz,764,271,286,557,0.7290000000000001,988,RW,1967,1981
David Backes,950,245,312,557,0.586,1144,RW/C,2006,2021
Mike Murphy,831,238,318,556,0.669,514,RW,1971,1983
Pete Stemkowski,967,206,349,555,0.574,866,C,1963,1978
Bengt-Ake Gustafsson,629,196,359,555,0.882,196,C,1979,1989
Don Luce,894,225,329,554,0.62,364,C,1969,1982
David Perron,854,223,328,551,0.645,650,LW/RW,2007,2021
Logan Couture,720,258,292,550,0.764,191,C,2009,2021
John Cullen,621,187,363,550,0.8859999999999999,898,C,1988,1999
Mike Knuble,1068,278,270,548,0.513,641,RW,1996,2013
Mike Sillinger,1049,240,308,548,0.522,644,C,1990,2009
Bill Cowley,549,195,353,548,0.998,143,C,1934,1947
Nikita Kucherov,515,221,326,547,1.062,261,RW,2013,2021
James Neal,822,289,256,545,0.6629999999999999,570,RW,2008,2021
Martin Erat,881,176,369,545,0.619,506,RW/LW,2001,2015
Max Bentley,645,245,299,544,0.843,179,C,1940,1954
Benoit Hogue,863,222,321,543,0.629,877,C,1987,2002
Doug Bentley,565,219,324,543,0.961,217,LW,1939,1954
Gary Dornhoefer,787,214,328,542,0.6890000000000001,1291,RW,1963,1978
Craig Conroy,1009,182,360,542,0.537,603,C,1994,2011
Bill Goldsworthy,771,283,258,541,0.7020000000000001,763,RW,1964,1978
Mark Napier,767,235,306,541,0.705,157,RW,1978,1989
Bill Mosienko,711,258,282,540,0.759,121,RW,1941,1955
Doug Harvey,1113,88,452,540,0.485,1216,D,1947,1969
Kris Letang,813,127,412,539,0.6629999999999999,584,D,2006,2021
Andrew Ladd,950,249,289,538,0.5660000000000001,568,LW/RW,2005,2020
Jordan Staal,962,225,312,537,0.5579999999999999,475,C,2006,2021
Viktor Kozlov,897,198,339,537,0.599,248,C/RW,1994,2009
Glen Wesley,1457,128,409,537,0.369,1045,D,1987,2008
Tim Young,628,195,341,536,0.8540000000000001,438,F,1975,1985
Danny Grant,736,263,272,535,0.727,239,RW,1965,1979
Ron Sutter,1093,205,330,535,0.489,1352,C,1982,2001
Calle Johansson,1110,119,416,535,0.48200000000000004,519,D,1987,2004
Kenny Wharram,766,252,281,533,0.696,222,C,1951,1969
Travis Zajac,995,196,337,533,0.536,340,C,2006,2021
Erik Cole,892,265,267,532,0.596,659,LW,2001,2015
Mark Osborne,919,212,319,531,0.578,1152,LW,1981,1995
Tomas Holmstrom,1027,243,287,530,0.516,763,RW,1996,2012
Guy Charron,734,221,309,530,0.722,185,C,1969,1981
Dave Poulin,724,205,325,530,0.732,482,C,1982,1995
Ron Stewart,1353,276,253,529,0.391,560,C,1952,1973
Camille Henry,719,279,249,528,0.7340000000000001,96,LW,1953,1970
Syd Howe,698,237,301,528,0.7559999999999999,212,LW,1929,1946
Joe Murphy,779,233,295,528,0.6779999999999999,710,RW,1986,2001
Bryan McCabe,1135,145,383,528,0.465,1732,D,1995,2011
Doug Bodger,1071,106,422,528,0.493,1007,D,1984,2000
Toe Blake,577,235,292,527,0.9129999999999999,272,LW,1934,1948
Lucien Deblois,993,249,276,525,0.529,814,RW,1977,1992
Dustin Byfuglien,869,177,348,525,0.604,1094,D,2005,2020
Derek Roy,738,189,335,524,0.71,391,C,2003,2015
Jean-Pierre Dumont,822,214,309,523,0.636,364,RW,1998,2011
Milan Lucic,961,206,316,522,0.5429999999999999,1130,LW,2007,2021
Jordan Eberle,728,227,294,521,0.716,172,RW,2010,2021
Bryan Little,843,217,304,521,0.618,293,C,2007,2021
Mike Rogers,484,202,317,519,1.072,184,C,1979,1986
Tim Horton,1446,115,403,518,0.358,1611,D,1949,1974
Alexander Syomin,650,239,278,517,0.795,582,RW/LW,2003,2016
Ron Schock,909,166,351,517,0.569,260,C,1963,1978
Yanic Perreault,859,247,269,516,0.601,392,C,1993,2008
Jeff Friesen,893,218,298,516,0.578,488,LW,1994,2007
Nels Stewart,650,324,191,515,0.792,953,C,1925,1940
Antoine Vermette,1046,228,287,515,0.49200000000000005,622,C,2003,2018
Valtteri Filppula,1023,191,324,515,0.503,336,C/LW,2005,2021
Aaron Broten,748,186,329,515,0.6890000000000001,441,C,1980,1992
Brian Rafalski,833,79,436,515,0.618,282,D,1999,2011
Jere Lehtinen,875,243,271,514,0.5870000000000001,210,LW,1995,2010
Bob Murray,1008,132,382,514,0.51,873,D,1975,1990
Tiger Williams,962,241,272,513,0.5329999999999999,3966,LW,1974,1988
Bob Nystrom,900,235,278,513,0.57,1248,RW,1972,1986
Shawn Horcoff,1008,186,325,511,0.507,624,C,2000,2016
Pat Flatley,780,170,340,510,0.654,686,RW,1983,1997
Donald Audette,735,260,249,509,0.693,584,RW,1989,2004
Mark Johnson,669,203,305,508,0.759,260,C,1979,1990
Joel Otto,943,195,313,508,0.539,1934,C,1984,1998
Darryl Sydor,1291,98,409,507,0.39299999999999996,755,D,1991,2010
Kyle Okposo,800,196,310,506,0.633,443,RW/C,2007,2021
Lynn Libett,982,237,268,505,0.514,472,LW,1967,1981
Brad Boyes,822,211,294,505,0.614,251,RW,2003,2016
Drew Doughty,923,118,386,504,0.546,637,D,2008,2021
Brian Campbell,1082,87,417,504,0.466,277,D,1999,2017
Brian Bradley,651,182,321,503,0.773,528,C,1985,1998
Dennis Hextall,681,153,350,503,0.7390000000000001,1398,LW,1967,1980
Nathan MacKinnon,530,192,310,502,0.9470000000000001,197,C/RW,2013,2021
Bob Gainey,1160,239,262,501,0.43200000000000005,585,LW,1973,1989
Valeri Kamensky,637,200,301,501,0.7859999999999999,383,LW,1991,2002
Greg Malone,704,191,310,501,0.7120000000000001,661,C,1976,1987
Mike Green,880,150,351,501,0.569,592,D,2005,2020
Ed Jovanovski,1128,137,363,500,0.44299999999999995,1491,D,1995,2014
Wayne Simmonds,915,251,248,499,0.545,1138,RW,2008,2021
Gregg Sheppard,657,205,293,498,0.758,243,LW,1972,1982
Todd Marchant,1195,186,312,498,0.41700000000000004,774,C,1993,2011
Pierre Pilote,890,80,418,498,0.56,1251,D,1955,1969
Craig Simpson,634,247,250,497,0.784,659,LW,1985,1995
Radek Bonk,969,194,303,497,0.513,581,C,1994,2009
Jeff O'Neill,821,237,259,496,0.604,670,RW,1995,2007
Al Secord,766,273,222,495,0.6459999999999999,2095,LW,1978,1990
Sylvain Turgeon,669,269,226,495,0.74,691,LW,1983,1995
Darcy Rota,794,256,239,495,0.623,973,LW,1973,1984
Lubomir Visnovsky,883,128,367,495,0.561,373,D,2000,2015
Keith Crowder,662,223,271,494,0.746,1344,RW,1980,1990
Dion Phaneuf,1048,137,357,494,0.47100000000000003,1345,D,2005,2019
Tony Granato,773,248,244,492,0.636,1425,LW,1988,2001
Andre Boudrias,662,151,340,491,0.742,214,LW,1963,1976
Dirk Graham,772,219,270,489,0.633,917,RW,1983,1995
Andy McDonald,685,182,307,489,0.7140000000000001,280,C/LW,2000,2013
Steve Rucchin,735,171,318,489,0.665,164,C,1994,2007
Nelson Emerson,771,195,293,488,0.633,575,RW,1990,2002
Marco Sturm,938,242,245,487,0.519,446,LW,1997,2012
Derick Brassard,857,187,300,487,0.568,407,C/W,2007,2021
Mike Richards,749,181,306,487,0.65,585,C,2005,2016
James van Riemsdyk,746,250,236,486,0.6509999999999999,307,LW,2009,2021
Jason Blake,871,213,273,486,0.5579999999999999,455,LW,1998,2012
Bruce Driver,922,96,390,486,0.527,670,D,1983,1998
Jason Allison,552,154,331,485,0.879,441,C,1993,2006
Mark Giordano,896,135,350,485,0.541,745,D,2005,2021
Patric Hornqvist,772,241,243,484,0.627,395,RW,2008,2021
Michael Ryder,806,237,247,484,0.6,353,RW,2003,2015
Don Marcotte,868,230,254,484,0.5579999999999999,317,LW,1965,1982
Claude Larose,943,226,257,483,0.512,889,RW,1962,1978
Michal Handzus,1010,185,298,483,0.478,498,C,1998,2014
Tod Sloan,745,220,262,482,0.647,831,C,1947,1961
Andre Savard,790,211,271,482,0.61,411,C,1973,1985
John Carlson,762,106,376,482,0.633,260,D,2009,2021
Derek Stepan,743,168,313,481,0.647,188,C,2010,2021
Craig MacTavish,1093,213,267,480,0.439,891,C,1979,1997
Gerard Gallant,615,211,269,480,0.78,1674,LW,1984,1995
Yvon Lambert,683,206,273,479,0.701,340,LW,1972,1982
Ron Murphy,889,205,274,479,0.539,460,LW,1952,1970
Jim Fox,578,186,293,479,0.8290000000000001,143,RW,1980,1990
Dale McCourt,532,194,284,478,0.898,124,C,1977,1984
Paul Henderson,707,236,241,477,0.675,304,RW,1962,1980
Dallas Drake,1009,177,300,477,0.473,885,LW,1992,2008
Josh Bailey,869,154,323,477,0.5489999999999999,231,RW/LW,2008,2021
Eric Vail,591,216,260,476,0.805,281,LW,1973,1982
Darcy Tucker,947,215,261,476,0.503,1410,LW,1995,2010
Connor McDavid,357,166,310,476,1.3330000000000002,124,C,2015,2021
Victor Hedman,765,105,371,476,0.622,560,D,2009,2021
Busher Jackson,633,241,234,475,0.75,437,LW,1929,1944
Dit Clapper,833,228,246,474,0.569,462,D/F,1927,1947
John McKenzie,691,206,268,474,0.6859999999999999,917,RW,1958,1972
Howie Morenz,550,271,201,472,0.858,546,C,1923,1937
Sid Abel,612,189,283,471,0.77,376,C/LW,1938,1954
Doug Risebrough,740,185,286,471,0.636,1542,C,1974,1987
Alexei Zhitnik,1085,96,375,471,0.434,1268,D,1992,2008
Bruce MacGregor,890,213,257,470,0.528,217,C,1960,1974
Mike Keane,1161,168,302,470,0.405,881,RW,1988,2004
Lee Stempniak,911,203,266,469,0.515,327,RW,2005,2019
Rob Niedermayer,1153,186,283,469,0.40700000000000003,904,RW/C,1993,2011
Frans Nielsen,900,166,303,469,0.521,166,C,2006,2021
Nick Foligno,913,198,270,468,0.513,744,W/C,2007,2021
Steve Kasper,821,177,291,468,0.57,554,C,1980,1993
Jyrki Lumme,985,114,354,468,0.475,620,D,1988,2003
Jeff Skinner,725,258,208,466,0.643,324,LW/C,2010,2021
Steve Payne,613,228,238,466,0.76,435,LW,1978,1988
Gary Leeman,667,199,267,466,0.6990000000000001,531,RW,1982,1997
Eddie Shack,1047,239,226,465,0.444,1437,LW,1958,1975
Gabriel Landeskog,638,201,264,465,0.7290000000000001,491,LW/RW,2011,2021
Nikolai Antropov,788,193,272,465,0.59,627,C/RW,1999,2013
Michael Peca,864,176,289,465,0.5379999999999999,798,C,1993,2009
Mikael Renberg,661,190,274,464,0.7020000000000001,372,RW,1993,2004
Doug Crossman,914,105,359,464,0.508,534,D,1980,1994
Brent Seabrook,1114,103,361,464,0.41700000000000004,661,D,2005,2021
Jochen Hecht,833,186,277,463,0.556,458,C/LW,1998,2013
Kelly Miller,1057,181,282,463,0.43799999999999994,512,LW,1984,1999
Al Iafrate,799,152,311,463,0.579,1301,D,1984,1998
Fredrik Modin,898,232,230,462,0.514,453,LW,1996,2011
Cliff Koroll,814,208,254,462,0.568,376,RW,1969,1980
Evander Kane,718,243,218,461,0.642,960,LW,2009,2021
Aurele Joliat,655,270,190,460,0.7020000000000001,771,LW,1922,1938
Doug Smail,845,210,249,459,0.5429999999999999,602,RW,1980,1993
Sam Gagner,848,164,295,459,0.541,385,C/RW,2007,2021
Ron Stackhouse,889,87,372,459,0.516,824,D,1970,1982
Sami Kapanen,831,189,269,458,0.551,175,LW,1995,2008
Wade Redden,1023,109,348,457,0.447,665,D,1996,2013
Pierre Mondou,548,194,262,456,0.8320000000000001,179,RW,1976,1985
Wayne Merrick,774,191,265,456,0.589,303,C,1972,1984
Jude Drouin,666,151,305,456,0.685,346,C,1968,1981
Travis Green,970,193,262,455,0.469,764,C,1992,2007
Per-Erik Eklund,594,120,335,455,0.7659999999999999,109,C,1985,1994
Jerry Korab,975,114,341,455,0.467,1629,D,1970,1985
Pat Boutette,756,171,282,453,0.599,1354,C/LW,1975,1985
Alex Pietrangelo,763,110,343,453,0.594,241,D,2008,2021
Charlie Huddy,1017,99,354,453,0.445,785,D,1980,1997
Derek Sanderson,598,202,250,452,0.7559999999999999,911,C,1965,1978
Dan Maloney,737,192,259,451,0.612,1489,LW,1970,1982
Kristian Huselius,662,190,261,451,0.6809999999999999,256,LW,2001,2012
Randy Burridge,706,199,251,450,0.637,458,LW,1985,1998
Blaine Stoughton,526,258,191,449,0.8540000000000001,204,LW,1973,1984
Mark Scheifele,523,182,267,449,0.8590000000000001,225,C,2011,2021
Johnny Gaudreau,467,153,296,449,0.961,100,LW,2013,2021
Mike Walton,588,201,247,448,0.762,357,C,1965,1979
Dean McAmmond,996,186,262,448,0.45,490,LW,1991,2010
Ryan Nugent-Hopkins,610,171,277,448,0.7340000000000001,201,C/LW,2011,2021
Milan Michalek,747,208,238,446,0.597,394,LW/RW,2003,2017
Dick Redmond,771,133,312,445,0.5770000000000001,504,D,1969,1982
Harry Watson,809,236,207,443,0.5479999999999999,150,LW,1941,1957
Ryan Johansen,664,144,299,443,0.667,409,C,2011,2021
Jonathan Huberdeau,538,149,292,441,0.82,253,LW,2012,2021
Shawn Burr,878,181,269,440,0.501,1069,LW,1984,2000
Ian Turnbull,628,123,316,440,0.701,736,D,1973,1983
Serge Savard,1040,106,333,439,0.42200000000000004,592,D,1966,1983
Mike O'Connell,860,105,334,439,0.51,605,D,1977,1990
Wayne Babych,519,192,246,438,0.8440000000000001,498,RW,1978,1987
Rob Brown,543,190,248,438,0.807,599,RW,1987,2000
Brandon Dubinsky,823,153,285,438,0.532,905,C/LW,2006,2021
Willi Plett,834,222,215,437,0.524,2572,RW,1975,1988
Vic Stasiuk,745,183,254,437,0.5870000000000001,669,LW,1949,1963
John Tucker,656,177,259,436,0.665,285,C,1983,1996
Mariusz Czerkawski,745,215,220,435,0.584,274,RW,1993,2006
Chico Maki,841,143,292,435,0.517,345,RW,1960,1976
Sylvain Cote,1171,122,313,435,0.371,545,D,1984,2003
Tyler Bozak,737,162,272,434,0.589,212,C,2009,2021
Mark Streit,786,96,338,434,0.552,374,D,2005,2018
Curt Fraser,704,193,240,433,0.615,1306,LW,1978,1990
Gaetan Duchesne,1028,179,254,433,0.42100000000000004,617,LW,1981,1995
Allan Stanley,1244,100,333,433,0.348,792,D,1948,1969
Mario Marois,955,76,357,433,0.45299999999999996,1746,D,1977,1992
Syl Apps,423,201,231,432,1.021,56,C,1936,1948
Brayden Schenn,662,181,251,432,0.653,357,C/W,2009,2021
Christian Ruuttu,621,134,298,432,0.696,714,C,1986,1995
Niklas Kronwall,953,83,349,432,0.45299999999999996,564,D,2003,2019
Tim Connolly,697,131,300,431,0.618,300,C,1999,2012
Kevin Lowe,1254,84,347,431,0.344,1498,D,1979,1998
Ab McDonald,762,182,248,430,0.564,200,LW,1957,1972
Tom Williams,663,161,269,430,0.649,177,RW,1961,1976
Woody Dumart,772,211,218,429,0.556,99,LW,1935,1954
Hakan Loob,450,193,236,429,0.953,189,RW,1983,1989
Leon Draisaitl,428,170,259,429,1.002,144,C/W,2014,2021
Mickey Redmond,538,233,195,428,0.7959999999999999,219,RW,1967,1976
Vladimir Tarasenko,507,214,214,428,0.8440000000000001,145,RW,2012,2021
Drew Stafford,841,196,232,428,0.509,415,RW,2006,2019
Jiri Hudler,708,164,264,428,0.605,243,LW,2003,2017
Carey Wilson,552,169,258,427,0.774,314,C,1983,1993
P.K. Subban,717,105,322,427,0.596,801,D,2009,2021
Roy Conacher,490,226,200,426,0.8690000000000001,90,LW,1938,1952
Lorne Carr,580,204,222,426,0.7340000000000001,132,RW,1933,1946
Ilkka Sinisalo,582,204,222,426,0.732,206,RW,1981,1992
Terry Ruskowski,630,113,313,426,0.6759999999999999,1342,C,1979,1989
Hooley Smith,715,200,225,425,0.594,1013,D/F,1924,1941
Frank St. Marseille,707,140,285,425,0.601,242,RW,1967,1977
Jim Peplinski,711,161,263,424,0.596,1467,LW/RW,1980,1995
Phil Russell,1016,99,325,424,0.41700000000000004,2038,D,1972,1987
Derek Morris,1107,92,332,424,0.38299999999999995,1004,D,1997,2014
Jay Bouwmeester,1240,88,336,424,0.342,635,D,2002,2020
Gerry Meehan,670,180,243,423,0.631,111,C,1968,1979
Bill Fairbairn,658,162,261,423,0.643,173,RW,1968,1979
Frank Boucher,548,161,262,423,0.772,118,C,1921,1944
Stephen Weiss,732,156,267,423,0.578,341,C,2001,2015
Robert Picard,899,104,319,423,0.47100000000000003,1025,D,1977,1990
Walt Poddubny,468,184,238,422,0.902,454,RW,1981,1992
Nathan Horton,627,203,218,421,0.6709999999999999,567,RW,2003,2020
Anson Carter,674,202,219,421,0.625,229,RW,1996,2007
Tom Kurvers,659,93,328,421,0.639,350,D,1984,1995
Joffrey Lupul,701,205,215,420,0.599,407,RW,2003,2018
Marty McInnis,796,170,250,420,0.528,330,C,1991,2003
Artemi Panarin,395,150,270,420,1.063,122,LW,2015,2021
Patrice Brisebois,1009,98,322,420,0.41600000000000004,623,D,1990,2009
Gordie Roberts,1097,61,359,420,0.38299999999999995,1582,D,1979,1994
Morris Lukowich,582,199,219,418,0.718,584,LW,1979,1987
Harry Howell,1411,94,324,418,0.29600000000000004,1298,D,1952,1973
Bill Flett,689,202,215,417,0.605,501,RW,1967,1980
Marek Zidlicky,836,89,328,417,0.499,680,D,2003,2016
Bill Derlago,555,189,227,416,0.75,247,C,1978,1987
Ed Litzenberger,618,178,238,416,0.6729999999999999,283,RW,1952,1964
Sean Monahan,544,195,220,415,0.763,119,C,2013,2021
Jason Chimera,1107,186,229,415,0.375,892,LW/RW,2000,2018
Kyle Turris,732,165,250,415,0.5670000000000001,331,C,2007,2021
Dave Balon,776,192,222,414,0.534,607,LW,1959,1973
Randy Cunneyworth,866,189,225,414,0.478,1280,LW,1980,1999
Roman Josi,636,109,305,414,0.6509999999999999,234,D,2011,2021
Brian MacLellan,606,172,241,413,0.682,551,D/LW,1982,1992
Matt Stajan,1003,146,267,413,0.41200000000000003,526,C,2002,2018
Craig Hartsburg,570,98,315,413,0.725,818,D,1979,1989
Darren Turcotte,635,195,216,411,0.647,301,C,1988,2000
Aleksander Barkov,481,155,255,410,0.852,86,C,2013,2021
Alexandre Burrows,913,205,204,409,0.44799999999999995,1134,RW/LW,2005,2018
Pascal Dupuis,871,190,219,409,0.47,387,LW,2000,2017
Phil Watson,590,144,265,409,0.693,532,C,1935,1948
Rejean Houle,635,161,247,408,0.643,395,RW,1969,1983
Alex Goligoski,873,80,328,408,0.467,296,D,2007,2021
Jerry Toppazzini,783,163,244,407,0.52,436,RW,1952,1964
David Schriner,484,201,204,405,0.8370000000000001,148,LW,1934,1946
Petri Skriko,541,183,222,405,0.7490000000000001,246,LW/RW,1984,1993
Earl Ingarfield,746,179,226,405,0.5429999999999999,239,C,1958,1971
Pat Hickey,644,192,212,404,0.627,351,F,1975,1985
Blake Dunlop,550,130,274,404,0.735,172,F,1973,1984
Mike McEwen,716,108,296,404,0.564,460,D,1976,1988
Adam Creighton,708,187,216,403,0.569,1077,C,1983,1997
Sean Couturier,649,156,247,403,0.621,255,C,2011,2021
Doug Jarvis,964,139,264,403,0.418,263,C,1975,1988
Brad McCrimmon,1222,81,322,403,0.33,1416,D,1979,1997
Paul Gardner,447,201,201,402,0.899,207,C,1976,1986
Bill Hicke,729,168,234,402,0.551,395,RW,1958,1972
Marc Tardif,517,194,207,401,0.7759999999999999,443,LW,1969,1983
Alexander Edler,878,99,302,401,0.457,611,D,2006,2021
Herb Cain,570,206,194,400,0.7020000000000001,178,LW,1933,1946
Alan Haworth,524,189,211,400,0.763,425,C,1980,1988
Valeri Bure,621,174,226,400,0.644,221,RW,1994,2006
Mike McPhee,744,200,199,399,0.536,661,LW,1983,1994
Tom McCarthy,461,178,221,399,0.866,330,LW,1979,1988
Andrew Cogliano,1013,165,234,399,0.39399999999999996,345,C/LW,2007,2021
Jim Lorentz,659,161,238,399,0.605,208,C,1968,1978
Adrian Aucoin,1108,121,278,399,0.36,796,D,1994,2013
Petr Svoboda,1028,58,341,399,0.38799999999999996,1605,D,1984,2001
Eric Daze,601,226,172,398,0.662,176,LW,1994,2006
Charlie Conacher,459,225,173,398,0.867,523,RW,1929,1941
Anders Hedberg,465,172,226,398,0.856,144,RW,1978,1985
Matt Cooke,1046,167,231,398,0.38,1135,LW,1998,2015
George Ferguson,797,160,238,398,0.499,431,C,1972,1984
Steve Chiasson,751,93,305,398,0.53,1107,D,1986,1999
Alexander Frolov,579,175,222,397,0.6859999999999999,218,LW,2002,2011
Clint Smith,483,161,236,397,0.8220000000000001,24,C,1936,1947
Scott Walker,829,151,246,397,0.479,1162,RW,1994,2010
Buddy O'Connor,509,140,257,397,0.78,34,C,1941,1951
Steve Konowalchuk,790,171,225,396,0.501,703,LW,1991,2006
Gus Bodnar,667,142,254,396,0.594,207,C,1943,1955
Nazem Kadri,617,181,214,395,0.64,492,C,2009,2021
Maxim Afinogenov,651,158,237,395,0.607,486,RW,1999,2010
Errol Thompson,599,208,185,393,0.6559999999999999,184,LW,1970,1981
Mark Stone,454,151,242,393,0.866,149,RW,2011,2021
R.J. Umberger,779,180,212,392,0.503,312,C/W,2005,2016
Dennis Ververgaert,583,176,216,392,0.672,247,RW,1973,1981
Cal Gardner,696,154,238,392,0.563,517,C,1945,1957
Mats Zuccarello,576,129,263,392,0.6809999999999999,233,RW,2010,2021
Yevgeni Kuznetsov,483,121,271,392,0.812,250,C,2013,2021
Andy Hebenton,630,189,202,391,0.621,83,RW,1955,1964
Lowell MacDonald,506,180,210,390,0.7709999999999999,92,RW,1961,1978
Dave Manson,1103,102,288,390,0.354,2792,D,1986,2002
Jarret Stoll,872,144,244,388,0.445,618,C,2002,2016
Eric Weinrich,1157,70,318,388,0.335,825,D,1988,2006
Mark Parrish,722,215,172,387,0.536,246,RW,1998,2011
Marty Barry,509,195,192,387,0.76,231,C,1927,1940
Ric Seiling,738,179,208,387,0.524,573,RW,1977,1987
Daniel Cleary,938,165,222,387,0.413,492,RW/LW,1997,2015
Dennis Wideman,815,99,288,387,0.475,503,D,2005,2017
Ryan Callahan,757,186,200,386,0.51,428,RW,2006,2020
Mika Zibanejad,552,177,209,386,0.6990000000000001,159,C,2011,2021
Bill Hay,506,113,273,386,0.763,244,C,1959,1967
Pavel Kubina,970,110,276,386,0.39799999999999996,1123,D,1997,2012
Mark Hunter,628,213,171,384,0.611,1426,RW,1981,1993
Bob Probert,935,163,221,384,0.41100000000000003,3300,LW,1985,2002
Michael Frolik,850,159,225,384,0.452,317,RW/LW,2008,2021
Sergei Makarov,424,134,250,384,0.9059999999999999,317,RW,1989,1997
Zarley Zalapski,637,99,285,384,0.603,684,D,1987,2000
Kevin Shattenkirk,684,83,301,384,0.561,412,D,2010,2021
Jeff Norton,799,52,332,384,0.48100000000000004,615,D,1987,2002
Jean-Guy Gendron,863,182,201,383,0.444,701,LW,1955,1972
Mike Grier,1060,162,221,383,0.361,510,RW,1996,2011
Mush March,759,153,230,383,0.505,540,RW,1928,1945
Bob Errey,895,170,212,382,0.42700000000000005,1005,LW,1983,1998
Steven Reinprecht,663,140,242,382,0.5760000000000001,186,C,1999,2011
Martin Lapointe,991,181,200,381,0.384,1417,RW,1991,2008
Todd White,653,141,240,381,0.583,228,C,1997,2011
Adam Henrique,670,187,192,379,0.5660000000000001,204,C/LW,2010,2021
David Pastrnak,390,180,199,379,0.972,171,RW,2014,2021
Andrei Kovalenko,620,173,206,379,0.611,389,RW,1992,2001
Orest Kindrachuk,507,118,261,379,0.748,648,C,1972,1982
Richard Zednik,745,199,179,378,0.507,563,LW,1995,2009
Greg Gilbert,837,147,228,378,0.452,576,LW,1981,1996
German Titov,624,157,220,377,0.604,311,C,1993,2002
Bob Kelly,837,154,208,377,0.45,1454,LW,1970,1982
Mike Johnson,661,129,246,375,0.5670000000000001,315,RW,1996,2008
Steve Smith,804,72,303,375,0.466,2139,D,1984,2001
Doug Brown,854,160,214,374,0.43799999999999994,210,RW,1986,2001
Adam Deadmarsh,567,184,189,373,0.6579999999999999,819,RW,1994,2003
Jeff Halpern,976,152,221,373,0.382,641,C,1999,2014
Greg Paslawski,650,187,185,372,0.5720000000000001,169,RW,1983,1994
Dean Evason,803,139,233,372,0.46299999999999997,1000,C,1983,1996
Johnny Gottselig,589,176,195,371,0.63,203,LW,1928,1945
Tony Hrkac,758,132,239,371,0.489,173,C,1986,2003
Johan Franzen,602,187,183,370,0.615,401,LW,2005,2020
Ryan Malone,647,179,191,370,0.5720000000000001,693,LW,2003,2015
Juha Widing,575,144,226,370,0.643,208,C,1969,1977
John-Michael Liles,836,87,283,370,0.44299999999999995,286,D,2003,2017
Moe Mantha,656,81,289,370,0.564,501,D,1980,1992
Cam Atkinson,576,198,171,369,0.6409999999999999,142,RW,2011,2021
Sid Smith,601,186,183,369,0.614,94,LW,1946,1958
Matt Moulson,650,176,193,369,0.568,122,LW/RW,2007,2018
Dave Reid,961,165,204,369,0.384,253,LW,1983,2001
Fleming Mackell,665,149,220,369,0.555,562,C,1947,1960
Greg Johnson,785,145,224,369,0.47,345,C,1993,2007
Stefan Persson,622,52,317,369,0.593,574,D,1977,1986
Brad Maxwell,612,98,270,368,0.601,1292,D,1977,1987
Jim Neilson,1023,69,299,368,0.36,904,D,1962,1978
Mark Hardy,915,62,306,368,0.402,1293,D,1979,1994
Bill Cook,474,229,138,367,0.774,386,RW,1926,1937
Artyom Anisimov,754,178,189,367,0.48700000000000004,214,C/LW,2008,2021
Mikael Backlund,693,146,221,367,0.53,337,C/W,2008,2021
Oliver Ekman Larsson,725,125,242,367,0.506,452,D,2010,2021
Gary Bergman,838,68,299,367,0.43799999999999994,1249,D,1964,1976
Jorgen Pettersson,435,174,192,366,0.841,117,LW,1980,1986
Ruslan Fedotenko,863,173,193,366,0.424,472,LW/RW,2000,2013
Jaden Schwartz,524,146,220,366,0.698,135,LW,2011,2021
Grant Ledyard,1028,90,276,366,0.35600000000000004,766,D,1984,2002
Mike Comrie,589,168,197,365,0.62,443,C,2000,2011
Marcus Johansson,653,130,235,365,0.5589999999999999,108,C/LW,2010,2021
Kris Draper,1157,161,203,364,0.315,790,C,1990,2011
Troy Brouwer,851,182,181,363,0.42700000000000005,595,RW/LW,2006,2020
Randy McKay,932,162,201,363,0.389,1731,RW,1988,2003
Jean-Claude Tremblay,794,57,306,363,0.457,204,D,1959,1972
"Bryan Hextall, Sr.",449,187,175,362,0.8059999999999999,227,LW,1936,1948
Mike Hoffman,496,173,187,360,0.726,177,W/C,2011,2021
Paul Ranheim,1013,161,199,360,0.355,288,LW,1988,2003
Brian Savage,674,192,167,359,0.5329999999999999,321,LW,1993,2006
Tim Ecclestone,692,126,233,359,0.519,344,RW,1967,1978
Marty McSorley,961,108,251,359,0.374,3381,D,1983,2000
Kris Versteeg,643,149,209,358,0.557,374,RW/LW,2007,2018
Eric Belanger,820,138,220,358,0.43700000000000006,361,C,2000,2013
Behn Wilson,601,98,260,358,0.596,1480,D,1978,1988
John Van Boxmeer,588,84,274,358,0.609,465,D,1973,1984
Jamie Macoun,1128,76,282,358,0.317,1210,D,1982,1999
Gary Sabourin,627,169,188,357,0.569,397,RW,1967,1977
Ray Neufeld,595,157,200,357,0.6,816,RW,1979,1990
Reilly Smith,582,146,211,357,0.613,150,RW/LW,2011,2021
Filip Forsberg,462,169,187,356,0.7709999999999999,204,LW/RW,2012,2021
Bill Clement,719,148,208,356,0.495,383,C,1971,1982
Pierre-Marc Bouchard,593,110,246,356,0.6,190,C,2002,2014
Matt Niskanen,949,72,284,356,0.375,489,D,2007,2020
Dan Hamhuis,1148,59,297,356,0.31,684,D,2003,2020
Barry Beck,615,104,251,355,0.5770000000000001,1016,D,1977,1990
Risto Siltanen,562,90,265,355,0.632,266,D,1979,1987
Todd Gill,1007,82,272,354,0.35200000000000004,1214,D,1984,2003
Ted Hampson,676,108,245,353,0.522,94,C,1959,1972
Tomas Tatar,580,169,183,352,0.607,218,LW/RW,2010,2021
Tim Higgins,706,154,198,352,0.499,719,RW,1978,1989
Mikael Granlund,541,111,241,352,0.6509999999999999,150,C/RW,2012,2021
Perry Turnbull,608,188,163,351,0.5770000000000001,1245,LW,1979,1988
Dave Lowry,1084,164,187,351,0.324,1191,LW,1985,2004
Niklas Sundstrom,750,117,232,349,0.465,256,C,1995,2006
Brandon Saad,593,170,178,348,0.5870000000000001,112,LW/RW,2011,2021
John Madden,898,165,183,348,0.38799999999999996,219,C,1998,2012
Gustav Nyquist,570,146,202,348,0.611,144,LW/RW,2011,2021
Tyson Barrie,560,80,268,348,0.621,179,D,2011,2021
Jacques Richard,556,160,187,347,0.624,307,C,1972,1983
Mike Corrigan,594,151,196,347,0.584,698,LW,1967,1978
Ted Donato,796,150,197,347,0.436,396,LW,1991,2004
Mikael Samuelsson,699,149,197,346,0.495,370,RW,2000,2014
Tuomo Ruutu,735,146,200,346,0.47100000000000003,596,LW/RW,2003,2016
Stan Weir,642,139,207,346,0.539,183,C,1972,1983
Igor Korolyov,795,119,227,346,0.435,330,C,1992,2004
George Sullivan,557,107,239,346,0.621,441,C,1949,1961
Vladimir Malakhov,712,86,260,346,0.486,697,D,1992,2006
Sergio Momesso,710,152,193,345,0.486,1557,LW,1983,1997
Sergei Nemchinov,761,152,193,345,0.45299999999999996,251,C,1991,2002
Billy Harris,769,126,219,345,0.449,205,C,1955,1969
Marcel Pronovost,1206,88,257,345,0.28600000000000003,851,D,1949,1970
Jaroslav Spacek,880,82,263,345,0.392,628,D,1998,2012
Mike Ramsey,1070,79,266,345,0.322,1012,D,1979,1997
Gaye Stewart,502,185,159,344,0.685,274,RW,1941,1954
Real Cloutier,317,146,198,344,1.085,119,RW,1979,1985
Reijo Ruotsalainen,446,107,237,344,0.7709999999999999,180,D,1981,1990
Tomas Jonsson,552,85,259,344,0.623,482,D,1981,1989
Greg Polis,615,174,169,343,0.5579999999999999,391,LW,1970,1980
Nick Mickoski,703,158,185,343,0.488,319,RW,1947,1960
Trent Klatt,782,143,200,343,0.439,307,RW,1991,2004
Jack Eichel,359,137,206,343,0.955,136,C,2015,2021
Brian Skrudland,881,124,219,343,0.389,1107,C,1985,2000
Mattias Ohlund,909,93,250,343,0.377,885,D,1997,2016
Doug Lidster,897,75,268,343,0.382,679,D,1983,1999
Pat Elynuik,506,154,188,342,0.6759999999999999,449,RW,1987,1996
Duane Sutter,731,139,203,342,0.46799999999999997,1333,RW,1979,1990
Keith Brown,876,68,274,342,0.39,916,D,1979,1995
Craig Laughlin,549,136,205,341,0.621,364,RW,1981,1989
Bill Thoms,548,135,206,341,0.622,154,C,1932,1945
Kyle Palmieri,565,175,165,340,0.602,290,RW,2010,2021
Bob Berry,541,159,181,340,0.628,344,LW,1968,1977
Tyler Johnson,536,153,187,340,0.634,170,C/W,2012,2021
Christian Ehrhoff,789,74,266,340,0.431,517,D,2003,2016
Joe Carveth,504,150,189,339,0.6729999999999999,81,RW,1940,1951
Sami Salo,878,99,240,339,0.386,286,D,1998,2014
Scott Arniel,730,149,189,338,0.46299999999999997,599,LW,1981,1992
Robert Kron,771,144,194,338,0.43799999999999994,119,LW,1990,2002
Torey Krug,527,67,271,338,0.6409999999999999,222,D,2011,2021
Brendan Gallagher,552,174,163,337,0.611,314,RW,2012,2021
Alexander Radulov,443,138,199,337,0.7609999999999999,308,RW/LW,2006,2021
Martin Hanzal,673,126,211,337,0.501,574,C,2007,2020
Pat Stapleton,635,43,294,337,0.531,353,D,1961,1973
Steve Heinze,694,178,158,336,0.484,379,RW,1991,2003
Paul Ysebaert,532,149,187,336,0.632,217,LW,1988,1999
Ian Laperriere,1082,121,215,336,0.311,1949,RW,1993,2012
Dale Tallon,642,98,238,336,0.523,568,D,1970,1980
Kevin Miller,620,150,185,335,0.54,429,RW,1988,2004
Lynn Patrick,455,145,190,335,0.736,240,LW,1934,1946
Tomas Fleischmann,657,137,198,335,0.51,200,LW,2005,2016
Brad Stuart,1056,80,255,335,0.317,565,D,1999,2016
Robert Svehla,655,68,267,335,0.511,649,D,1994,2003
Randy Wood,741,175,159,334,0.451,603,LW,1986,1997
Curt Bennett,580,152,182,334,0.5760000000000001,347,LW/RW,1970,1980
Bobby Lalonde,641,124,210,334,0.521,298,C,1971,1982
Cooney Weiland,509,173,160,333,0.654,147,C,1928,1939
Chris Higgins,711,165,168,333,0.46799999999999997,220,LW,2003,2016
Filip Kuba,836,70,263,333,0.39799999999999996,361,D,1998,2013
Johnny Wilson,688,161,171,332,0.483,190,LW,1949,1962
Paul Thompson,582,153,179,332,0.57,336,LW,1926,1939
Simon Nolet,562,150,182,332,0.591,187,RW,1967,1977
Brooks Laich,776,134,198,332,0.428,307,C/LW,2003,2018
Dave Barr,614,128,204,332,0.541,520,RW,1981,1994
Orland Kurtenbach,639,119,213,332,0.52,628,C,1960,1974
Ulf Samuelsson,1080,57,275,332,0.307,2453,D,1984,2000
Steve Bozek,641,164,167,331,0.516,309,LW,1981,1992
Craig Smith,664,162,169,331,0.498,266,RW,2011,2021
Ted Irvine,724,154,177,331,0.457,657,LW,1963,1977
Ondrej Palat,499,112,219,331,0.6629999999999999,153,LW,2012,2021
Derian Hatcher,1045,79,252,331,0.317,1581,D,1991,2009
Rod Seiling,979,62,269,331,0.33799999999999997,601,D,1962,1979
Gilles Tremblay,509,168,162,330,0.648,161,LW,1960,1969
Metro Prystai,674,151,179,330,0.49,231,C,1947,1958
Miroslav Frycer,415,147,183,330,0.795,486,RW,1981,1989
Cy Denneny,325,248,81,329,1.012,266,LW,1917,1929
Tom Fitzgerald,1097,139,190,329,0.3,776,RW,1988,2006
Mark Pavelich,355,137,192,329,0.927,340,C,1981,1992
Todd Elik,448,111,218,329,0.7340000000000001,453,C,1989,1997
Jim McKenny,604,82,247,329,0.545,294,D,1965,1979
Rod Langway,994,51,278,329,0.331,851,D,1978,1993
Ken Houston,570,161,167,328,0.575,624,RW,1975,1984
Doug Sulliman,631,160,168,328,0.52,175,RW,1979,1990
Ron Flockhart,453,145,183,328,0.7240000000000001,208,RW,1980,1989
Michel Petit,827,90,238,328,0.397,1839,D,1982,1998
Alexandre Daigle,616,129,198,327,0.531,186,C,1993,2006
Mikkel Bodker,709,118,209,327,0.461,116,LW/RW,2008,2020
Tom Poti,824,69,258,327,0.397,586,D,1998,2013
Patrik Berglund,717,170,156,326,0.455,248,C/W,2008,2019
Johnny Peirson,545,153,173,326,0.598,315,RW,1946,1958
Bronco Horvath,434,141,185,326,0.7509999999999999,319,C,1955,1968
Ron Wilson,832,110,216,326,0.392,415,C/LW,1979,1994
Marc-Edouard Vlasic,1040,72,254,326,0.313,404,D,2006,2021
Doug Shedden,416,139,186,325,0.7809999999999999,176,C,1981,1991
Ken Schinkel,636,127,198,325,0.511,163,RW,1959,1973
Bob Dailey,561,94,231,325,0.579,814,D,1973,1982
Tony Leswick,740,165,159,324,0.43799999999999994,900,LW,1945,1958
Ebbie Goodfellow,557,134,190,324,0.5820000000000001,511,D/F,1929,1943
Mathieu Perreault,631,130,194,324,0.513,304,C/LW,2009,2021
Elias Lindholm,528,122,202,324,0.614,120,C/RW,2013,2021
Willy Lindstrom,582,161,162,323,0.555,200,RW,1979,1987
Paul Holmgren,527,144,179,323,0.613,1684,RW,1975,1985
Parker MacDonald,676,144,179,323,0.478,253,LW,1952,1969
Alexei Ponikarovsky,678,139,184,323,0.47600000000000003,419,LW,2000,2013
Dave Hunter,746,133,190,323,0.433,918,LW,1979,1989
Gord Murphy,862,85,238,323,0.375,668,D,1988,2002
Bryan Berard,619,76,247,323,0.522,500,D,1996,2008
Chris Stewart,668,160,162,322,0.48200000000000004,750,RW/LW,2008,2020
Pat Falloon,575,143,179,322,0.56,141,RW,1991,2000
Mike York,579,127,195,322,0.556,135,C,1999,2009
Leo Boivin,1150,72,250,322,0.28,1192,D,1951,1970
Alex Galchenyuk,551,136,185,321,0.583,205,C/LW,2012,2021
Leo Labine,643,128,193,321,0.499,730,RW,1951,1962
William Huber,655,104,217,321,0.49,950,D,1978,1988
Gilles Marotte,808,56,265,321,0.397,919,D,1965,1977
Dennis Kearns,677,31,290,321,0.474,386,D,1971,1981
Jimmy Roberts,1006,126,194,320,0.318,621,D/RW,1963,1978
Don Raleigh,535,101,219,320,0.598,96,C,1943,1956
Paul Martin,870,50,270,320,0.368,238,D,2003,2018
Gary Croteau,684,144,175,319,0.466,143,LW/RW,1968,1980
Blake Comeau,852,136,183,319,0.374,532,LW/RW,2006,2021
Janne Niinimaa,741,54,265,319,0.43,733,D,1996,2007
George Gee,551,135,183,318,0.5770000000000001,345,C,1945,1954
Chris Kreider,527,158,159,317,0.602,445,LW,2011,2021
David Vyborny,543,113,204,317,0.584,228,C,2000,2008
Oleg Tverdovsky,713,77,240,317,0.445,291,D,1994,2007
Dave Maloney,657,71,246,317,0.48200000000000004,1154,D,1974,1985
Rene Bourque,725,163,153,316,0.436,584,LW/RW,2005,2017
Larry Patey,717,153,163,316,0.441,631,C,1973,1985
Stephane Matteau,848,144,172,316,0.373,742,LW,1990,2003
Andre St-Laurent,644,129,187,316,0.491,749,C,1973,1984
Rich Sutter,874,149,166,315,0.36,1411,RW,1982,1995
Dave Creighton,616,140,174,314,0.51,223,C,1948,1960
J.T. Miller,507,122,192,314,0.619,233,C/W,2012,2021
Jason Woolley,718,68,246,314,0.43700000000000006,430,D,1991,2006
Tyler Ennis,616,133,180,313,0.508,202,C/W,2009,2021
Flash Hollett,562,132,181,313,0.557,358,D,1933,1946
Alex Killorn,588,132,181,313,0.532,337,LW,2012,2021
Paul Ronty,488,101,211,312,0.639,103,C,1947,1955
John Chabot,508,84,228,312,0.614,85,C,1983,1991
Bill Collins,768,157,154,311,0.405,415,C,1967,1978
Rob Zamuner,798,139,172,311,0.39,467,LW,1991,2004
Ladislav Nagy,435,115,196,311,0.715,358,LW/RW,1999,2008
Johan Garpenlov,609,114,197,311,0.511,278,RW,1990,2000
Ron Hainsey,1132,59,252,311,0.275,443,D,2002,2020
Steve Tambellini,553,160,150,310,0.561,105,C,1978,1988
Dustin Penner,589,151,159,310,0.526,354,LW,2005,2014
Joe Corvo,708,92,218,310,0.43799999999999994,241,D,2002,2014
Herbie Lewis,483,148,161,309,0.64,248,LW,1928,1939
Rick Meagher,691,144,165,309,0.447,383,C,1979,1991
Ken Mosdell,693,141,168,309,0.446,475,C,1941,1959
Ryane Clowe,491,112,197,309,0.629,618,LW,2005,2018
Kelly Buchberger,1182,105,204,309,0.261,2297,RW,1986,2004
Trevor Daley,1058,89,220,309,0.292,648,D,2003,2020
Michal Rozsival,963,68,241,309,0.321,704,D,1999,2018
Sergei Brylin,765,129,179,308,0.40299999999999997,273,W/C,1994,2008
Adam Foote,1154,66,242,308,0.267,1534,D,1991,2011
Nick Leddy,724,63,245,308,0.425,137,D,2010,2021
Tobias Enstrom,719,54,254,308,0.428,422,D,2007,2018
Tyler Toffoli,530,150,157,307,0.579,150,RW,2012,2021
Wayne Connelly,543,133,174,307,0.565,156,RW,1960,1972
Floyd Smith,616,129,178,307,0.498,207,C/RW,1954,1972
Teddy Purcell,571,101,206,307,0.5379999999999999,102,LW/RW,2007,2017
Jocelyn Guevremont,571,84,223,307,0.5379999999999999,319,D,1971,1980
Boris Mironov,716,76,231,307,0.429,891,D,1993,2004
Dallas Smith,890,55,252,307,0.345,959,D,1959,1978
Jonathan Cheechoo,501,170,135,305,0.609,324,RW,2002,2010
Chris Simon,782,144,161,305,0.39,1824,LW,1992,2008
Brent Gilchrist,792,135,170,305,0.385,400,LW,1988,2003
Clarke MacArthur,552,133,172,305,0.5529999999999999,343,LW,2006,2020
Claude Lapointe,879,127,178,305,0.34700000000000003,721,C,1990,2004
Dave Hannan,841,114,191,305,0.363,942,C,1981,1997
Anders Lee,497,174,130,304,0.612,307,LW,2012,2021
Bob Gould,697,145,159,304,0.436,572,RW,1979,1990
Joel Ward,726,133,171,304,0.419,261,RW,2006,2018
Charlie Burns,749,106,198,304,0.406,252,C,1958,1973
John Ferguson,500,145,158,303,0.606,1214,LW/RW,1963,1971
Erik Johnson,777,80,223,303,0.39,476,D,2007,2021
Bun Cook,473,158,144,302,0.638,444,LW,1926,1937
Wayne Presley,684,155,147,302,0.442,953,RW,1984,1996
Jack Johnson,941,70,232,302,0.321,523,D,2006,2021
Cam Fowler,684,68,234,302,0.442,185,D,2010,2021
Niklas Hagman,770,147,154,301,0.391,220,LW/RW,2001,2012
Andrew McBain,608,129,172,301,0.495,633,RW,1983,1994
Art Jackson,468,123,178,301,0.643,144,C,1934,1945
Dougie Hamilton,555,96,205,301,0.542,360,D,2012,2021
Ryan McDonagh,665,63,238,301,0.45299999999999996,274,D,2010,2021
Curtis Brown,736,129,171,300,0.408,398,C/LW,1994,2008
Matthew Barnaby,834,113,187,300,0.36,2562,LW,1992,2007
Sheldon Souray,758,109,191,300,0.396,1145,D,1997,2015
Lindy Ruff,691,105,195,300,0.434,1264,D,1979,1991
Philippe Boucher,748,94,206,300,0.401,702,D,1992,2009
Mitchell Marner,306,87,212,299,0.977,108,RW,2016,2021
Cecil Dillon,453,167,131,298,0.6579999999999999,105,RW,1930,1940
Sean Hill,876,62,236,298,0.34,1008,D,1990,2008
Brock Nelson,552,152,145,297,0.5379999999999999,207,C,2012,2021
Pierre Plante,599,125,172,297,0.496,599,RW,1971,1980
Jan Hrdina,513,101,196,297,0.579,341,C,1998,2006
Hec Kilrea,633,167,129,296,0.46799999999999997,438,LW,1925,1940
Babe Siebert,592,140,156,296,0.5,982,LW,1925,1939
Lars Eller,759,133,163,296,0.39,462,C,2009,2021
Kyle Brodziak,917,129,167,296,0.32299999999999995,462,C,2005,2020
Mikhail Grabovski,534,125,171,296,0.5539999999999999,312,C,2006,2018
Pierre-Alexandre Parenteau,491,114,182,296,0.603,342,RW,2006,2017
Brian Benning,568,63,233,296,0.521,963,D,1984,1995
Manny Malhotra,991,116,179,295,0.298,451,C,1998,2015
Gordie Drillon,311,155,139,294,0.945,56,RW,1936,1943
Marian Stastny,322,121,173,294,0.9129999999999999,110,RW,1981,1986
Valeri Zelepukin,595,117,177,294,0.494,527,LW,1991,2001
Kyle Calder,590,114,180,294,0.498,309,LW,1999,2010
John Klingberg,426,58,236,294,0.69,156,D,2014,2021
Bret Hedican,1039,55,239,294,0.28300000000000003,893,D,1991,2009
Alain Cote,696,103,190,293,0.42100000000000004,383,LW,1979,1989
Doug Halward,653,69,224,293,0.449,774,D,1975,1989
Nino Niederreiter,604,139,153,292,0.483,291,RW/LW,2010,2021
Jakob Silfverberg,563,138,154,292,0.519,164,RW/LW,2011,2021
Chuck Lefley,407,128,164,292,0.7170000000000001,137,C,1970,1981
Babe Pratt,517,83,209,292,0.565,463,D/LW,1935,1947
Rich Preston,580,127,164,291,0.502,348,RW,1979,1987
Chris Kelly,845,123,168,291,0.344,417,C/LW,2003,2018
Teuvo Teravainen,431,91,200,291,0.675,72,W/C,2013,2021
Auston Matthews,287,160,130,290,1.01,46,C,2016,2021
Tyler Myers,709,81,209,290,0.409,535,D,2009,2021
Grant Warwick,395,147,142,289,0.732,220,RW,1941,1950
Lou Angotti,653,103,186,289,0.44299999999999995,228,C,1964,1974
Darren McCarty,758,127,161,288,0.38,1477,RW,1993,2009
Brad May,1041,127,161,288,0.27699999999999997,2248,LW,1991,2010
Bob Sweeney,639,125,163,288,0.451,799,C,1986,1996
Steve Ott,848,109,179,288,0.34,1555,C/W,2002,2017
Francois Beauchemin,903,76,212,288,0.319,501,D,2002,2018
Chris Phillips,1179,71,217,288,0.244,756,D,1997,2016
Greg Smith,829,56,232,288,0.34700000000000003,1110,RW,1975,1988
Ethan Moreau,928,147,140,287,0.309,1110,LW,1995,2012
Vincent Trocheck,430,114,173,287,0.667,276,C,2013,2021
Per-Johan Axelsson,797,103,184,287,0.36,276,LW,1997,2009
Jean Potvin,613,63,224,287,0.46799999999999997,478,D,1970,1981
Sergei Berezin,502,160,126,286,0.57,54,LW,1996,2003
Tomas Hertl,458,135,151,286,0.624,137,C/LW,2013,2021
Colin Wilson,632,113,173,286,0.45299999999999996,138,LW/C,2009,2020
Charlie Coyle,574,110,176,286,0.498,211,C/RW,2012,2021
Chris Oddleifson,524,95,191,286,0.546,464,RW,1972,1981
Rick Lanz,569,65,221,286,0.503,448,D,1980,1992
Scott Thornton,941,144,141,285,0.303,1459,LW,1990,2008
Scottie Upshall,759,138,147,285,0.375,615,LW/RW,2002,2018
Stew Gavin,768,130,155,285,0.371,584,RW,1980,1993
Garry Monahan,748,116,169,285,0.381,484,C,1967,1979
Norm Maciver,500,55,230,285,0.57,350,D,1986,1998
Jean-Guy Talbot,1056,43,242,285,0.27,1006,D,1954,1971
Grant Mulvey,586,149,135,284,0.485,816,RW,1974,1984
Ales Kotalik,542,136,148,284,0.524,348,RW/LW,2001,2011
Rickard Rakell,452,129,155,284,0.628,96,W/C,2012,2021
Eddie Shore,550,105,179,284,0.516,1047,D,1926,1940
Kim Johnsson,739,67,217,284,0.384,406,D,1999,2010
Bill Quackenbush,774,62,222,284,0.36700000000000005,95,D,1942,1956
King Clancy,592,136,147,283,0.478,914,D,1921,1937
Stephen Leach,702,130,153,283,0.40299999999999997,976,RW,1985,2000
Nick Bonino,631,123,160,283,0.44799999999999995,173,C,2009,2021
Matt Carle,730,45,238,283,0.38799999999999996,251,D,2005,2017
Bo Horvat,452,125,157,282,0.624,125,C,2014,2021
Dominic Moore,897,106,176,282,0.314,487,C,2003,2018
David Desharnais,524,87,195,282,0.5379999999999999,160,C/LW,2009,2018
Mike Zuke,455,86,196,282,0.62,220,C,1978,1986
Barry Gibbs,796,58,224,282,0.354,945,D,1967,1980
Joni Pitkanen,535,57,225,282,0.527,484,D,2003,2014
Jacques Laperriere,691,40,242,282,0.408,674,D,1962,1974
Hilliard Graves,556,118,163,281,0.505,209,RW,1970,1980
Uwe Krupp,729,69,212,281,0.385,660,D,1986,2003
Taylor Pyatt,859,140,140,280,0.326,430,LW,2000,2014
Eddie Wiseman,456,115,165,280,0.614,136,RW,1932,1942
Edgar Laprade,500,108,172,280,0.56,42,C,1945,1955
Carl Soderberg,552,103,177,280,0.507,192,C/LW,2012,2021
Andrei Nikolishin,628,93,187,280,0.446,270,LW,1994,2004
Jared Spurgeon,658,82,198,280,0.426,114,D,2010,2021
Darryl Sutter,406,161,118,279,0.687,288,LW,1979,1987
Brandon Sutter,733,144,134,278,0.379,147,C/RW,2008,2021
Vaclav Nedomansky,421,122,156,278,0.66,88,C,1977,1983
Glen Sharpley,389,117,161,278,0.715,199,C,1976,1982
Armand Guidolin,519,107,171,278,0.536,616,LW,1942,1952
Garnet Bailey,568,107,171,278,0.489,633,LW,1968,1978
Kevin Bieksa,808,63,215,278,0.344,1124,D,2005,2018
Bob Murdoch,757,60,218,278,0.36700000000000005,762,D,1970,1982
Larry Aurie,489,148,129,277,0.5660000000000001,289,RW,1927,1939
Mud Bruneteau,411,139,138,277,0.674,80,RW,1935,1946
Carl Liscombe,373,137,140,277,0.743,117,LW,1937,1946
Stephan Lebeau,373,118,159,277,0.743,105,C,1988,1995
Kevin Hayes,455,117,160,277,0.609,134,C,2014,2021
Michael Grabner,640,175,101,276,0.431,110,LW/RW,2009,2020
Doug Wickenheiser,556,111,165,276,0.496,286,C,1980,1990
Rob DiMaio,894,106,170,276,0.309,840,RW,1988,2007
Justin Faulk,632,92,184,276,0.43700000000000006,299,D,2011,2021
Earl Seibert,645,89,187,276,0.428,746,D,1931,1946
Curtis Glencross,507,134,141,275,0.542,351,LW,2006,2015
Jim Peters,574,125,150,275,0.479,186,RW,1945,1954
Brian Noonan,629,116,159,275,0.43700000000000006,517,RW,1987,1999
John Marks,657,112,163,275,0.419,330,D,1972,1982
Erwin Chamberlain,510,100,175,275,0.539,769,C,1937,1949
Joe Cirella,828,64,211,275,0.332,1448,D,1981,1996
Jimmy Ward,527,147,127,274,0.52,455,RW,1927,1939
Gilles Hamel,519,127,147,274,0.528,276,RW,1980,1989
Nikolai Kulyomin,669,121,153,274,0.41,173,LW/RW,2008,2018
Dwight Foster,541,111,163,274,0.506,420,RW,1977,1987
Igor Kravchuk,699,64,210,274,0.392,251,D,1991,2003
James Wisniewski,552,53,221,274,0.496,459,D,2005,2016
Reg Noble,510,167,106,273,0.535,925,C,1917,1933
Ray Getliffe,393,136,137,273,0.695,250,LW,1935,1945
Gino Cavallini,593,114,159,273,0.46,507,LW,1984,1993
Don Sweeney,1115,52,221,273,0.245,681,D,1988,2004
Ernie Hicke,520,132,140,272,0.523,407,LW,1970,1978
Marcel Bonin,454,97,175,272,0.599,336,LW,1952,1962
Dylan Larkin,394,110,161,271,0.688,253,C,2015,2021
Eric Brewer,1009,77,194,271,0.26899999999999996,792,D,1998,2015
Morgan Rielly,523,55,216,271,0.518,129,D,2013,2021
Jake Gardiner,622,49,222,271,0.436,215,D,2011,2021
Tom Bladon,610,73,197,270,0.44299999999999995,392,D,1972,1981
John Gould,504,131,138,269,0.534,113,LW,1971,1980
Dave Scatchard,659,128,141,269,0.408,1040,C,1997,2011
Shaun Van Allen,794,84,185,269,0.33899999999999997,481,C,1990,2004
T.J. Brodie,640,48,221,269,0.42,194,D,2010,2021
Leon Rochefort,617,121,147,268,0.434,93,RW,1960,1976
Garry Howatt,720,112,156,268,0.37200000000000005,1836,LW,1972,1984
Mike Allison,499,102,166,268,0.537,630,RW/LW,1980,1990
Billy Reay,479,105,162,267,0.557,202,C,1943,1953
Peter Ihnacak,417,102,165,267,0.64,175,C,1982,1990
Wojtek Wolski,451,99,168,267,0.5920000000000001,113,LW/RW,2005,2013
Billy Taylor,323,87,180,267,0.8270000000000001,120,C,1939,1948
Kenny Jonsson,686,63,204,267,0.389,298,D,1994,2004
Sebastian Aho,313,122,144,266,0.85,102,C/LW,2016,2021
Brayden Point,298,118,148,266,0.893,79,C,2016,2021
Brian Lawton,483,112,154,266,0.551,401,LW,1983,1993
Carl Hagelin,609,101,165,266,0.43700000000000006,254,LW,2011,2021
Marty Reasoner,798,97,169,266,0.33299999999999996,379,C,1998,2013
Mikko Makela,423,118,147,265,0.626,139,RW,1985,1995
Neil Colville,464,99,166,265,0.5710000000000001,213,D,1935,1949
Stephane Yelle,991,96,169,265,0.267,490,C,1995,2010
Bill White,604,50,215,265,0.439,495,D,1967,1976
Mikael Andersson,761,95,169,264,0.34700000000000003,144,W/C,1985,2000
Dan Girardi,927,56,208,264,0.285,315,D,2006,2019
Fyodor Tyutin,872,55,209,264,0.303,548,D,2003,2017
Tom Johnson,978,51,213,264,0.27,960,D,1947,1965
Buzz Boll,437,133,130,263,0.602,148,LW,1932,1944
Benoit Pouliot,625,130,133,263,0.42100000000000004,371,LW,2006,2018
Johnny Gagnon,454,120,141,263,0.579,295,RW,1930,1940
Jay Wells,1098,47,216,263,0.24,2359,D,1979,1997
Rick Green,845,43,220,263,0.311,588,D,1976,1992
Eddie Joyal,466,128,134,262,0.562,103,C,1962,1972
Josef Beranek,531,118,144,262,0.493,398,C,1991,2001
Jonas Hoglund,545,117,145,262,0.48100000000000004,112,RW,1996,2003
Matthew Lombardi,536,101,161,262,0.489,293,C,2003,2013
Benoit Brunet,539,101,161,262,0.486,229,LW,1988,2002
Dave Tippett,721,93,169,262,0.363,317,LW,1983,1994
Anton Stralman,820,52,210,262,0.32,267,D,2007,2021
Devin Setoguchi,516,131,130,261,0.506,177,RW,2007,2017
Jody Hull,831,124,137,261,0.314,156,RW,1988,2004
Nikolaj Ehlers,373,117,144,261,0.7,130,LW,2015,2021
Nikolai Zherdev,421,115,146,261,0.62,225,LW/RW,2003,2011
Vernon Fiddler,877,104,157,261,0.298,558,C/LW,2002,2017
Peter Schaefer,572,99,162,261,0.456,200,LW,1998,2011
Pat Price,726,43,218,261,0.36,1456,D,1975,1988
Raffi Torres,635,137,123,260,0.409,497,LW,2001,2015
Kirk Maltby,1072,128,132,260,0.243,867,LW,1993,2010
Bobby Bauer,327,123,137,260,0.795,36,RW,1936,1952
Wes Walz,607,109,151,260,0.428,343,C,1989,2008
"Bryan Hextall, Jr.",549,99,161,260,0.474,738,C,1962,1976
Jeff Petry,685,71,189,260,0.38,269,D,2010,2021
Dmitri Mironov,556,54,206,260,0.46799999999999997,568,D,1991,2001
Ryan Whitney,481,50,209,259,0.5379999999999999,383,D,2005,2014
Pat Hughes,573,130,128,258,0.45,646,RW,1977,1987
Ed Johnstone,426,122,136,258,0.606,375,RW,1975,1987
Keith Jones,491,117,141,258,0.525,765,RW,1992,2001
Paul MacDermid,690,116,142,258,0.374,1303,RW,1981,1995
Sam Reinhart,405,111,147,258,0.637,80,C/RW,2014,2021
Sergejs Zoltoks,588,111,147,258,0.439,166,C,1992,2004
Dean Talafous,497,104,154,258,0.519,163,RW/C,1974,1982
Dave Lumley,437,98,160,258,0.59,680,RW,1978,1987
Kevin McCarthy,537,67,191,258,0.48,527,D,1977,1987
Seth Jones,529,60,198,258,0.488,168,D,2013,2021
Stephane Robidas,937,57,201,258,0.275,713,D,1999,2017
Jason Zucker,476,138,118,256,0.5379999999999999,177,LW/RW,2011,2021
Jannik Hansen,626,109,147,256,0.409,282,RW/LW,2006,2018
Mikko Rantanen,286,103,153,256,0.895,126,RW,2015,2021
Mike Hough,707,100,156,256,0.36200000000000004,675,LW,1984,1999
Garry Valk,777,100,156,256,0.32899999999999996,747,LW/RW,1990,2003
Randy Robitaille,531,84,172,256,0.48200000000000004,201,C,1996,2008
Randy Manery,582,50,206,256,0.44,415,D,1970,1980
Terry Harper,1066,35,221,256,0.24,1362,D,1962,1981
Jonathan Marchessault,354,113,142,255,0.72,183,LW/RW,2012,2021
Jim Schoenfeld,719,51,204,255,0.355,1132,D,1972,1985
Tommy Albelin,956,44,211,255,0.267,417,D,1987,2006
Ryan Strome,495,95,159,254,0.513,268,C/RW,2013,2021
Bob Davidson,491,94,160,254,0.517,398,LW,1934,1946
Dan Daoust,522,87,167,254,0.48700000000000004,544,C,1982,1990
Ted Green,620,48,206,254,0.41,1029,D,1960,1972
Don Saleski,543,128,125,253,0.466,629,RW,1971,1980
Tommy Williams,397,115,138,253,0.637,73,LW,1971,1979
Doug Smith,535,115,138,253,0.473,624,C,1981,1990
Max Domi,380,81,172,253,0.6659999999999999,302,C/LW,2015,2021
Ryan Ellis,531,70,183,253,0.47600000000000003,179,D,2011,2021
Paul Mara,734,64,189,253,0.345,776,D,1998,2011
Jake Muzzin,585,62,191,253,0.43200000000000005,356,D,2010,2021
Babe Dye,272,203,49,252,0.9259999999999999,220,RW,1919,1931
Justin Abdelkader,739,106,146,252,0.341,608,LW/RW,2007,2020
Marty Pavelich,634,93,159,252,0.397,454,LW,1947,1957
Lyle Odelein,1056,50,202,252,0.239,2316,D,1989,2006
Mason Raymond,546,115,136,251,0.46,156,LW/RW,2007,2017
Ed Sandford,502,106,145,251,0.5,355,LW,1947,1956
Daniel Winnik,798,82,169,251,0.315,367,W/C,2007,2018
Dennis Seidenberg,859,44,207,251,0.292,359,D,2002,2019
Patrik Laine,306,140,110,250,0.8170000000000001,118,RW/LW,2016,2021
Nick Metz,518,131,119,250,0.483,149,LW,1934,1948
Chris Neil,1026,112,138,250,0.244,2522,RW,2001,2017
Andreas Dackell,613,91,159,250,0.408,162,LW,1996,2004
Darrin Shannon,506,87,163,250,0.494,344,LW,1988,1998
Bill Houlder,846,59,191,250,0.29600000000000004,412,D,1987,2003
Jean-Jacques Daigneault,898,53,197,250,0.278,667,D,1984,2001
Jaroslav Modry,725,49,201,250,0.345,510,D,1993,2008
David Volek,396,95,154,249,0.629,201,LW,1988,1994
Jiri Slegr,622,56,193,249,0.4,838,D,1992,2006
Andy Greene,937,49,200,249,0.266,261,D,2006,2021
Derek Plante,450,96,152,248,0.551,140,C,1993,2001
Sean Avery,580,90,157,247,0.426,1533,LW/C,2001,2012
John Sorrell,490,127,119,246,0.502,100,LW,1930,1941
Baldy Northcott,446,133,112,245,0.5489999999999999,273,D/LW,1928,1939
Andrew Shaw,535,115,130,245,0.45799999999999996,569,W/C,2011,2021
Peter John Lee,431,114,131,245,0.568,257,LW,1977,1983
Tie Domi,1020,104,141,245,0.24,3515,RW,1989,2006
Jan Bulis,552,96,149,245,0.444,268,C/LW,1997,2007
Tyler Arnason,486,88,157,245,0.504,140,C,2001,2009
Earl Reibel,409,84,161,245,0.599,75,C,1953,1959
Darren Veitch,449,45,200,245,0.546,269,D,1980,1991
Brad Richardson,812,107,137,244,0.3,406,C,2005,2021
Jay McClement,906,90,154,244,0.26899999999999996,325,C/D,2005,2017
Andre Dupont,800,59,185,244,0.305,1986,D,1970,1983
Andrej Sekera,765,47,197,244,0.319,194,D,2006,2021
Bill Hajt,854,42,202,244,0.28600000000000003,433,D,1973,1987
Keith McCreary,532,131,112,243,0.457,294,LW,1961,1975
Darren Helm,698,109,134,243,0.348,228,LW/C,2007,2021
Todd Krygier,543,100,143,243,0.44799999999999995,533,LW,1989,1998
Greg Terrion,561,93,150,243,0.433,339,LW,1980,1988
Joe Primeau,310,66,177,243,0.784,105,C,1927,1936
Jim Benning,610,52,191,243,0.39799999999999996,461,D,1981,1990
Patrick Eaves,633,132,110,242,0.382,210,RW/LW,2005,2020
Glen Skov,650,106,136,242,0.37200000000000005,413,C,1949,1961
Paul Gillis,624,88,154,242,0.38799999999999996,1498,C,1982,1993
Stephane Quintal,1037,63,179,242,0.233,1320,D,1988,2004
Curt Giles,895,43,199,242,0.27,733,D,1979,1993
Toni Lydman,847,36,206,242,0.28600000000000003,551,D,2000,2013
Alfred Lepine,526,143,98,241,0.45799999999999996,392,C,1925,1938
Bob Kudelski,442,139,102,241,0.545,218,RW,1987,1996
Shean Donovan,951,112,129,241,0.253,705,RW,1994,2010
Richard Park,738,102,139,241,0.327,266,RW/C,1994,2012
Paul Cyr,470,101,140,241,0.513,623,LW,1982,1992
Rich Peverley,442,84,157,241,0.545,167,C,2006,2015
Reggie Fleming,749,108,132,240,0.32,1468,LW/D,1959,1971
Danny Lewicki,461,105,135,240,0.521,177,LW,1950,1959
Inge Hammarstrom,427,116,123,239,0.56,86,RW,1973,1979
John Druce,531,113,126,239,0.45,347,RW,1988,1998
Reynald Comeau,564,98,141,239,0.424,175,C,1971,1980
Grant Marshall,700,92,147,239,0.341,793,RW,1994,2006
Kip Miller,449,74,165,239,0.532,105,LW,1990,2004
Jim Dowd,728,71,168,239,0.32799999999999996,390,C,1991,2008
Michael Del Zotto,662,56,183,239,0.361,272,D,2009,2021
"Lee Fogolin, Jr.",924,44,195,239,0.259,1318,D,1974,1987
Don Murdoch,320,121,117,238,0.7440000000000001,155,RW,1976,1982
Matthew Tkachuk,296,96,142,238,0.804,304,LW/RW,2016,2021
Brian Holzinger,547,93,145,238,0.435,339,C,1994,2004
Andrej Meszaros,645,63,175,238,0.369,457,D,2005,2015
Art Chapman,438,62,176,238,0.5429999999999999,140,C,1930,1940
Dan McGillis,634,56,182,238,0.375,570,D,1996,2006
Mike Milbury,754,49,189,238,0.316,1552,D,1975,1987
Cal Clutterbuck,828,120,117,237,0.28600000000000003,616,RW,2007,2021
Tom Chorske,596,115,122,237,0.39799999999999996,225,LW,1989,2000
Cody Eakin,591,103,134,237,0.401,242,C,2011,2021
Craig Rivet,923,50,187,237,0.257,1171,D,1994,2011
David Booth,530,124,112,236,0.445,216,LW/RW,2006,2018
Joe Klukay,566,109,127,236,0.41700000000000004,189,LW,1942,1956
Trent Hunter,497,101,135,236,0.475,209,RW,2001,2012
Mike Eastwood,783,87,149,236,0.301,354,C,1991,2004
Kris Russell,849,46,190,236,0.278,259,D,2007,2021
Steve Konroyd,895,41,195,236,0.264,863,D,1980,1995
Alexander Selivanov,459,121,114,235,0.512,379,RW,1994,2001
Mike Donnelly,465,114,121,235,0.505,255,LW,1986,1997
Kevin LaVallee,366,110,125,235,0.642,85,LW,1980,1987
Patrick Poulin,634,101,134,235,0.371,299,LW,1991,2002
Kyle Wellwood,489,92,143,235,0.48100000000000004,36,C,2003,2013
Marc-Andre Bergeron,490,82,153,235,0.48,214,D,2002,2013
Gaston Gingras,476,61,174,235,0.494,161,D,1979,1989
Shawn Chambers,625,50,185,235,0.376,364,D,1987,2000
Dave Trottier,446,121,113,234,0.525,517,F,1928,1939
Jimmy Thomson,787,19,215,234,0.297,920,D,1945,1958
Braydon Coburn,968,49,184,233,0.24100000000000002,708,D,2005,2021
Harold Snepsts,1033,38,195,233,0.226,2009,D,1974,1991
William Karlsson,415,101,131,232,0.5589999999999999,62,C,2014,2021
Bob Bassen,765,88,144,232,0.303,1004,C,1985,2000
Paul Cavallini,564,56,177,232,0.41100000000000003,750,D,1986,1996
Larry Hillman,790,36,196,232,0.294,579,D,1954,1973
Brian Boyle,805,130,101,231,0.287,588,C/LW,2007,2020
Blair Chapman,402,106,125,231,0.575,158,RW,1976,1983
Paul Gaustad,727,89,142,231,0.318,778,C,2002,2016
Ehrhardt Heller,647,55,176,231,0.35700000000000004,465,D,1931,1946
Barclay Plager,614,44,187,231,0.376,1115,D,1967,1977
Yves Racine,508,37,194,231,0.455,439,D,1989,1998
Steve Bernier,637,105,125,230,0.361,300,RW,2005,2018
Antti Miettinen,539,97,133,230,0.42700000000000005,234,W/C,2003,2013
Pat Egan,554,77,153,230,0.415,776,D,1939,1951
Terry Carkner,858,42,188,230,0.268,1588,D,1986,1999
Ron Sedlbauer,430,143,86,229,0.5329999999999999,210,LW,1974,1981
Jim Sandlak,549,110,119,229,0.41700000000000004,821,RW,1985,1996
Bud Poile,309,107,122,229,0.741,91,RW,1942,1950
Pat Maroon,516,97,132,229,0.444,586,LW,2011,2021
Val Fonteyne,820,75,154,229,0.27899999999999997,26,LW,1959,1972
Jason York,757,42,187,229,0.303,621,D,1992,2007
Sean O'Donnell,1224,31,198,229,0.187,1809,D,1994,2012
Gary McAdam,534,96,132,228,0.42700000000000005,243,LW,1975,1986
Zdeno Ciger,352,94,134,228,0.648,101,LW,1990,2002
William Nylander,313,88,140,228,0.728,76,RW,2015,2021
Keith Carney,1018,45,183,228,0.22399999999999998,904,D,1991,2008
Rasmus Ristolainen,498,43,185,228,0.45799999999999996,259,D,2013,2021
Vyacheslav Fetisov,546,36,192,228,0.418,656,D,1989,1998
Jason Williams,455,94,133,227,0.499,157,RW/C,2000,2012
Robbie Ftorek,334,77,150,227,0.68,262,C,1972,1985
Boone Jenner,494,115,111,226,0.457,303,C/LW,2013,2021
Jim McFadden,412,100,126,226,0.5489999999999999,89,C,1946,1954
Jay Pandolfo,899,100,126,226,0.251,164,LW,1996,2013
Mike Eaves,324,83,143,226,0.698,80,F,1978,1986
Chris Nilan,688,110,115,225,0.327,3043,RW,1979,1992
Lou Nanne,635,68,157,225,0.354,356,D,1967,1978
Randy Moller,815,45,180,225,0.276,1692,D,1981,1995
Dmitri Yushkevich,786,43,182,225,0.28600000000000003,659,D,1992,2003
Andrew Ference,907,43,182,225,0.248,753,D,1999,2017
Pete Horeck,426,106,118,224,0.526,340,LW,1944,1952
Magnus Arvedson,434,100,124,224,0.516,241,LW,1997,2004
Bob Leiter,447,98,126,224,0.501,144,C,1962,1976
Dixon Ward,537,95,129,224,0.41700000000000004,431,RW,1992,2003
Jan Hlavac,436,90,134,224,0.514,138,LW/RW,1999,2008
Bill Lindsay,777,83,141,224,0.28800000000000003,922,LW,1991,2004
Greg Hawgood,474,60,164,224,0.473,426,D,1987,2002
Bob Baun,964,37,187,224,0.23199999999999998,1493,D,1956,1973
Frank Nighbor,349,138,85,223,0.639,247,C,1917,1930
Todd Harvey,671,91,132,223,0.332,950,RW,1994,2006
Brian Spencer,553,80,143,223,0.40299999999999997,634,LW,1969,1979
Tom Gilbert,655,45,178,223,0.34,198,D,2006,2017
Dave Lewis,1008,36,187,223,0.221,953,D,1973,1988
Carl Brewer,604,25,198,223,0.369,1037,D,1957,1980
Red Hamill,419,128,94,222,0.53,160,LW,1937,1951
Brad Isbister,541,106,116,222,0.41,615,LW,1997,2008
Andrei Kostitsyn,398,103,119,222,0.5579999999999999,181,LW/RW,2005,2012
Andy Brickley,385,82,140,222,0.5770000000000001,81,LW,1982,1994
Gary Sargent,402,61,161,222,0.552,273,D,1975,1983
Craig Ludwig,1256,38,184,222,0.177,1437,D,1982,1999
Eric Fehr,652,113,108,221,0.33899999999999997,217,C/RW,2005,2019
Rick Blight,326,96,125,221,0.6779999999999999,170,RW,1975,1983
Michal Grosek,526,84,137,221,0.42,509,LW,1993,2004
Larry Popein,449,80,141,221,0.49200000000000005,162,C,1954,1968
Derek Armstrong,467,72,149,221,0.473,355,C,1993,2010
Butch Keeling,525,157,63,220,0.419,331,LW,1926,1938
Jamie McGinn,617,117,103,220,0.35700000000000004,267,LW,2008,2019
Steve Jensen,438,113,107,220,0.502,318,LW,1975,1982
Steve Staios,1001,56,164,220,0.22,1322,D,1995,2012
Rick Lapointe,664,44,176,220,0.331,831,D,1975,1986
Doug Jarrett,775,38,182,220,0.284,631,D,1964,1977
Normie Himes,402,106,113,219,0.545,127,C,1926,1935
Jerry Butler,641,99,120,219,0.342,515,RW,1972,1983
Jamal Mayers,915,90,129,219,0.239,1200,RW,1996,2013
Alexei Morozov,451,84,135,219,0.486,98,RW,1997,2004
Rick Smith,687,52,167,219,0.319,560,D,1968,1981
Chad Kilger,714,107,111,218,0.305,363,LW,1995,2008
Jack Valiquette,350,84,134,218,0.623,79,C,1974,1981
Brent Sopel,658,44,174,218,0.331,309,D,1998,2011
Bob Rouse,1061,37,181,218,0.205,1561,D,1983,2000
Viktor Arvidsson,339,118,99,217,0.64,151,RW/LW,2014,2021
Tanner Pearson,463,108,109,217,0.469,134,LW,2012,2021
Adam Brown,391,104,113,217,0.555,378,LW,1941,1952
Oleg Kvasha,493,81,136,217,0.44,335,LW,1998,2006
Scott Hannan,1055,38,179,217,0.20600000000000002,625,D,1998,2015
Vitali Yachmenyov,487,83,133,216,0.444,94,RW,1995,2003
Jan Erixon,556,57,159,216,0.38799999999999996,167,LW,1983,1993
Joe Watson,835,38,178,216,0.259,447,D,1964,1979
Rem Murray,560,94,121,215,0.384,161,C,1996,2006
Ray Cullen,313,92,123,215,0.687,120,C,1965,1971
Tyler Kennedy,527,89,126,215,0.408,239,C/RW,2007,2016
Gene Carr,465,79,136,215,0.462,365,C,1971,1979
Chris Clark,607,103,111,214,0.353,700,RW,1999,2011
Ted Bulley,414,101,113,214,0.517,704,LW,1976,1984
Gerry Ehman,429,96,118,214,0.499,100,RW,1957,1971
Aaron Ekblad,460,72,142,214,0.465,275,D,2014,2021
Jordan Leopold,695,67,147,214,0.308,293,D,2002,2015
Justin Schultz,487,50,164,214,0.439,110,D,2012,2021
Jean-Pierre Bordeleau,519,97,116,213,0.41,143,RW,1969,1980
Joe Sacco,738,94,119,213,0.289,421,RW,1990,2003
Alex Kaleta,387,92,121,213,0.55,190,LW,1941,1951
Brent Peterson,620,72,141,213,0.344,484,RW,1978,1989
Jonathan Drouin,354,67,146,213,0.602,128,LW,2014,2021
Harry Oliver,463,127,85,212,0.45799999999999996,147,RW,1926,1937
Robert Sirois,286,92,120,212,0.741,42,RW,1974,1980
Gerald Diduck,932,56,156,212,0.22699999999999998,1612,D,1984,2001
Curtis Leschyshyn,1033,47,165,212,0.205,669,D,1988,2004
Cody Franson,550,43,169,212,0.385,202,D,2009,2018
Paul Gagne,390,110,101,211,0.541,166,LW,1980,1990
Jack McIntyre,499,109,102,211,0.423,173,D/LW,1949,1960
Anders Kallur,372,101,110,211,0.5670000000000001,149,F,1979,1985
Tony Currie,290,92,119,211,0.728,73,RW,1977,1985
Jeff Shantz,642,72,139,211,0.32899999999999996,341,C,1993,2003
Mathew Barzal,238,61,150,211,0.887,134,C,2016,2021
Lee Norwood,503,57,154,211,0.419,1099,D,1980,1994
Daniel Marois,350,117,93,210,0.6,419,RW,1987,1996
Chuck Kobasew,601,110,100,210,0.349,394,RW,2002,2014
Ed Beers,250,94,116,210,0.84,256,LW,1981,1986
Mark Letestu,567,93,117,210,0.37,90,C,2009,2020
Jason Demers,663,45,165,210,0.317,391,D,2009,2021
Joe Lamb,443,108,101,209,0.47200000000000003,601,RW,1927,1938
Brent Fedyk,470,97,112,209,0.445,308,LW,1987,1999
Claude Loiselle,616,92,117,209,0.33899999999999997,1146,C,1981,1994
Corey Millen,335,90,119,209,0.624,236,C,1989,1997
Colby Armstrong,476,89,120,209,0.439,376,RW/LW,2005,2013
Alec Martinez,612,64,145,209,0.342,193,D,2009,2021
Kyle Connor,253,108,100,208,0.8220000000000001,74,LW,2016,2021
Charlie Sands,427,99,109,208,0.48700000000000004,58,RW,1932,1944
Nick Bjugstad,444,97,111,208,0.46799999999999997,202,C/RW,2012,2021
Arron Asham,789,94,114,208,0.264,1004,RW,1998,2014
Fred Harvey,407,90,118,208,0.511,131,RW,1970,1977
Dave Bolland,433,85,123,208,0.48,299,C,2006,2019
Fernie Flaman,910,34,174,208,0.22899999999999998,1370,D,1944,1961
Dave McLlwain,501,100,107,207,0.413,292,C,1987,1997
Hap Day,581,86,121,207,0.35600000000000004,597,D/LW,1924,1938
Kyle McLaren,719,46,161,207,0.28800000000000003,671,D,1995,2008
Shjon Podein,699,100,106,206,0.295,439,LW,1992,2003
Cully Dahlstrom,342,88,118,206,0.602,58,C,1937,1945
Per-Olov Brasar,348,64,142,206,0.5920000000000001,33,LW,1977,1982
Johnny Boychuk,725,54,152,206,0.284,331,D,2007,2021
Jacob Trouba,482,49,157,206,0.42700000000000005,360,D,2013,2021
Garth Butcher,897,48,158,206,0.23,2302,D,1981,1995
Brian Engblom,659,29,177,206,0.313,599,D,1976,1987
Terry Martin,479,104,101,205,0.428,202,LW,1975,1985
Colin Patterson,504,96,109,205,0.40700000000000003,239,F,1983,1993
Pierre Jarry,344,88,117,205,0.596,142,RW,1971,1978
Donald Brashear,1025,85,120,205,0.2,2634,LW,1993,2010
Bryan Erickson,351,80,125,205,0.584,141,RW,1983,1994
Buck Boucher,449,117,87,204,0.45399999999999996,838,D,1917,1932
Floyd Curry,601,105,99,204,0.33899999999999997,147,RW,1947,1958
Harold Cotton,503,101,103,204,0.406,419,LW,1925,1937
Jake Guentzel,248,99,105,204,0.823,98,W/C,2016,2021
Zack Smith,662,98,106,204,0.308,722,C/LW,2008,2021
Wilbert Hiller,383,91,113,204,0.5329999999999999,163,LW,1937,1946
Maxime Talbot,704,91,113,204,0.29,495,C/W,2005,2016
Don Grosso,336,87,117,204,0.607,90,C,1938,1947
Doc Romnes,360,68,136,204,0.5670000000000001,42,C,1930,1940
Dana Murzyn,838,52,152,204,0.243,1571,D,1985,1999
Ruslan Salei,916,45,159,204,0.223,1065,D,1996,2011
Frank Finnigan,556,115,88,203,0.365,405,RW,1923,1937
Yevgeni Dadonov,284,91,112,203,0.715,42,RW/LW,2009,2021
Kevin Todd,383,70,133,203,0.53,217,C,1988,1998
Mathieu Dandenault,868,69,135,203,0.23399999999999999,516,D/RW,1995,2009
Jean-Francois Sauve,290,65,138,203,0.7,114,C,1980,1987
Jason Wiemer,726,90,112,202,0.278,1420,C,1994,2006
Jim Conacher,328,85,117,202,0.616,91,C,1945,1953
Alexander Wennberg,417,40,162,202,0.484,85,C,2014,2021
Alex Shibicky,324,110,91,201,0.62,161,LW,1935,1946
Real Chevrefils,387,104,97,201,0.519,185,LW,1951,1959
Matt Calvert,553,95,106,201,0.363,370,LW/RW,2010,2021
Stan Jonathan,411,91,110,201,0.489,751,LW,1975,1983
Lauri Korpikoski,609,86,115,201,0.33,132,LW/RW,2007,2017
Trevor Letowski,616,84,117,201,0.326,209,RW,1998,2008
Terry Crisp,536,67,134,201,0.375,135,C,1965,1977
Jack Brownschidle,494,39,162,201,0.40700000000000003,151,D,1977,1986
Luke Richardson,1417,35,166,201,0.142,2055,D,1987,2009
David Clarkson,570,114,86,200,0.35100000000000003,992,RW,2006,2020
Bob Corkum,720,97,103,200,0.278,281,C,1989,2002
Dave Schultz,535,79,121,200,0.374,2294,LW,1971,1980
Mark Tinordi,663,52,148,200,0.302,1514,D,1987,1999
Jim Morrison,704,40,160,200,0.284,542,D,1951,1971
Elmer Vasko,786,34,166,200,0.254,719,D,1956,1970
Wally Hergesheimer,351,114,85,199,0.5670000000000001,106,RW,1951,1959
Chuck Arnason,401,109,90,199,0.496,122,RW,1971,1979
Phil Bourque,477,88,111,199,0.41700000000000004,516,LW/D,1983,1996
Samuel Pahlsson,798,68,131,199,0.249,354,C,2000,2012
Shayne Gostisbehere,340,51,148,199,0.585,123,D,2014,2021
Robyn Regehr,1090,36,163,199,0.183,972,D,1999,2015
Billy Burch,390,137,61,198,0.508,255,F,1922,1933
Andre Pronovost,556,94,104,198,0.35600000000000004,408,LW,1956,1968
Mel Hill,324,89,109,198,0.611,128,RW,1937,1946
Bates Battaglia,580,80,118,198,0.341,385,LW,1997,2008
Andre Lacroix,325,79,119,198,0.609,44,C,1967,1980
Shawn Bates,465,72,126,198,0.426,266,C/LW,1997,2008
Scott Pellerin,536,72,126,198,0.369,320,LW,1992,2004
Gus Mortson,797,46,152,198,0.248,1380,D,1946,1959
Ted Harris,788,30,168,198,0.251,1000,D,1963,1975
Brad Marsh,1086,23,175,198,0.182,1241,D,1978,1993
Bert Marshall,868,17,181,198,0.228,926,D,1965,1979
Troy Loney,624,87,110,197,0.316,1091,LW,1983,1995
George Allen,339,82,115,197,0.581,179,LW,1938,1947
Serge Bernier,302,78,119,197,0.652,234,RW,1968,1981
Terry Yake,403,77,120,197,0.489,220,C,1988,2001
Mattias Ekholm,542,45,152,197,0.363,265,D,2011,2021
John Bob Kelly,425,87,109,196,0.461,687,LW/RW,1973,1979
Steve Downie,434,76,120,196,0.452,1057,RW,2007,2016
Mike Eagles,853,74,122,196,0.23,928,LW,1982,2000
Paul Woods,501,72,124,196,0.391,276,C,1977,1984
Zach Bogosian,650,53,143,196,0.302,575,D,2008,2021
Martin Skoula,776,44,152,196,0.253,328,D,1999,2010
Sergei Krivokrasov,450,86,109,195,0.433,288,RW,1992,2002
Paul Haynes,391,61,134,195,0.499,164,C,1930,1941
Ken Klee,934,55,140,195,0.209,880,D,1994,2009
Hampus Lindholm,508,51,144,195,0.384,260,D,2013,2021
Richard Smehlik,644,49,146,195,0.303,415,D,1992,2003
Jim Johnson,829,29,166,195,0.235,1197,D,1985,1998
Gerry O'Flaherty,438,99,95,194,0.44299999999999995,168,RW,1971,1979
Tom Wilson,527,81,113,194,0.368,1029,RW,2012,2021
Derek Smith,335,78,116,194,0.579,60,C,1975,1983
Bob Miller,404,75,119,194,0.48,220,C,1977,1985
Wayne Primeau,774,69,125,194,0.251,789,C,1994,2010
Anatoli Semyonov,362,68,126,194,0.536,122,C,1989,1997
Greg de Vries,878,48,146,194,0.221,780,D,1995,2009
Sami Vatanen,434,45,149,194,0.447,192,D,2012,2021
David Shaw,769,41,153,194,0.252,906,D,1982,1998
Brooks Orpik,1035,18,176,194,0.187,972,D,2002,2019
Ace Bailey,313,111,82,193,0.617,472,RW,1926,1934
Andre Burakovsky,388,84,109,193,0.49700000000000005,99,LW/RW,2014,2021
Emile Bouchard,785,49,144,193,0.24600000000000002,863,D,1941,1956
Randy Gregg,474,41,152,193,0.40700000000000003,333,D,1981,1992
Frantisek Kaberle,523,29,164,193,0.369,218,D,1999,2009
Travis Konecny,304,88,104,192,0.632,163,RW/LW,2016,2021
Murray Murdoch,508,84,108,192,0.37799999999999995,197,LW,1926,1937
Glen Sather,658,80,112,192,0.292,724,LW,1966,1976
Chris Tierney,440,64,128,192,0.436,90,C,2014,2021
David Jones,462,104,87,191,0.413,122,RW,2007,2016
Blair MacDonald,219,91,100,191,0.872,65,RW,1979,1983
Georges Mantha,488,89,102,191,0.391,148,D/LW,1928,1941
Joey Johnston,331,85,106,191,0.5770000000000001,320,LW,1968,1976
Bob Gracie,379,82,109,191,0.504,205,C,1930,1939
Dave Gardner,350,75,115,190,0.5429999999999999,41,C,1972,1980
Turner Stevenson,644,75,115,190,0.295,969,RW,1992,2006
Joel Quenneville,803,54,136,190,0.237,705,D,1978,1991
Johnny Oduya,850,41,149,190,0.22399999999999998,372,D,2006,2018
Travis Hamonic,642,37,153,190,0.29600000000000004,595,D,2010,2021
Murray Wilson,386,94,95,189,0.49,162,F,1972,1979
Vladislav Namestnikov,430,83,106,189,0.44,227,C/W,2013,2021
Bill Hogaboam,332,80,109,189,0.569,100,C,1972,1980
Tom Anderson,319,62,127,189,0.5920000000000001,180,LW,1934,1942
Marc Staal,897,43,146,189,0.21100000000000002,434,D,2007,2021
Don Awrey,979,31,158,189,0.193,1065,D,1963,1979
Brett Connolly,498,98,90,188,0.37799999999999995,222,RW/LW,2011,2021
Matt Read,449,88,100,188,0.419,83,RW/LW,2011,2019
Marcel Goc,636,75,113,188,0.29600000000000004,157,C,2003,2015
Bill Gardner,380,73,115,188,0.495,68,C,1980,1989
Murray Armstrong,270,67,121,188,0.696,72,C,1937,1946
Jim Korn,597,66,122,188,0.315,1801,D/LW,1979,1990
Patrik Stefan,455,64,124,188,0.413,158,C,1999,2007
Alexander Karpovtsev,596,34,154,188,0.315,430,D,1993,2006
Paul Byron,453,89,98,187,0.413,125,W/C,2010,2021
Oleg Petrov,382,72,115,187,0.49,101,LW,1992,2003
Gregory Campbell,803,71,116,187,0.233,696,C,2003,2016
Alex Chiasson,524,92,94,186,0.355,296,RW/LW,2012,2021
Jean-Gabriel Pageau,439,90,96,186,0.424,172,C,2012,2021
Antoine Roussel,525,80,106,186,0.354,981,LW/RW,2012,2021
Kjell Samuelsson,813,47,138,186,0.22899999999999998,1225,D,1985,1999
Brett Clark,689,45,141,186,0.27,293,D,1997,2013
Jimmy Watson,613,38,148,186,0.303,492,D,1972,1982
Barret Jackman,876,29,157,186,0.212,1102,D,2001,2016
Tom Rowe,357,85,100,185,0.518,615,F,1976,1983
Howie Meeker,346,83,102,185,0.535,329,RW,1946,1954
Lionel Conacher,498,80,105,185,0.371,882,D,1925,1937
Marcus Foligno,570,76,109,185,0.325,493,LW,2011,2021
Arnie Brown,681,44,141,185,0.272,738,D,1961,1974
Calle Jarnkrok,462,82,102,184,0.39799999999999996,99,C/W,2013,2021
Bill Ezinicki,368,79,105,184,0.5,713,RW,1944,1955
Lorne Henning,544,73,111,184,0.33799999999999997,102,C,1972,1981
Hal Gill,1106,36,148,184,0.166,960,D,1997,2014
Sylvain Lefebvre,944,30,154,184,0.195,674,D,1989,2003
Paul Fenton,411,100,83,183,0.445,198,LW,1984,1992
Josef Vasicek,460,77,106,183,0.39799999999999996,311,C,2000,2008
Dave Hudson,409,59,124,183,0.447,89,C,1972,1978
Vaclav Varada,493,58,125,183,0.371,410,RW,1995,2006
Don Kozak,437,96,86,182,0.41600000000000004,480,RW,1972,1979
Mark Bell,450,87,95,182,0.40399999999999997,602,C/LW,2000,2012
Richard Panik,474,84,98,182,0.384,256,LW/RW,2012,2021
Mike Stapleton,687,71,111,182,0.265,342,C,1986,2001
Bryan Marchment,926,40,142,182,0.19699999999999998,2307,D,1988,2006
Mike Fidler,271,84,97,181,0.6679999999999999,124,LW,1976,1983
Earl Robinson,417,83,98,181,0.434,133,RW,1928,1940
Phil Roberto,385,75,106,181,0.47,464,RW,1969,1977
Dave Pichette,322,41,140,181,0.562,348,D,1980,1988
Marc Bergevin,1191,36,145,181,0.152,1090,D,1984,2004
Sean Bergenheim,506,96,84,180,0.35600000000000004,379,LW,2003,2015
Chad LaRose,508,85,95,180,0.354,286,RW/LW,2005,2013
Victor Rask,410,71,109,180,0.439,82,C,2014,2021
Kevin McClelland,588,68,112,180,0.306,1672,RW,1981,1994
Dmitri Orlov,520,37,143,180,0.34600000000000003,207,D,2011,2021
Willie Mitchell,907,34,146,180,0.198,787,D,1999,2016
Mike Rathje,768,30,150,180,0.23399999999999999,491,D,1993,2010
Denis Dupere,421,80,99,179,0.425,66,LW,1970,1978
Boyd Devereaux,627,67,112,179,0.285,205,LW,1997,2009
Danny O'Shea,370,64,115,179,0.484,265,C,1968,1973
Ian White,503,45,134,179,0.35600000000000004,254,D,2005,2013
Gerry Hart,730,29,150,179,0.245,1240,D,1968,1983
Alex DeBrincat,239,89,89,178,0.745,38,W/C,2017,2021
Zack Kassian,530,82,96,178,0.336,787,RW,2011,2021
David Moss,501,78,100,178,0.355,157,RW/LW,2006,2015
Jamie Hislop,345,75,103,178,0.516,86,RW,1979,1984
Forbes Kennedy,603,70,108,178,0.295,988,C,1956,1969
Phillip Danault,344,50,128,178,0.517,158,C,2014,2021
Zbynek Michalek,784,42,136,178,0.22699999999999998,322,D,2003,2017
Richard Matvichuk,796,39,139,178,0.22399999999999998,624,D,1992,2007
Jack Crawford,548,38,140,178,0.325,202,D,1937,1950
Ken Daneyko,1283,36,142,178,0.139,2516,D,1983,2003
Jiri Tlusty,446,89,88,177,0.397,126,LW/RW,2007,2016
John Mitchell,548,70,107,177,0.32299999999999995,267,C/LW,2008,2017
Matt Dumba,416,64,113,177,0.425,231,D,2013,2021
Marcus Ragnarsson,632,37,140,177,0.28,482,D,1995,2004
Tim Watters,741,26,151,177,0.239,1289,D,1981,1995
Jason Dawe,366,86,90,176,0.48100000000000004,162,LW,1993,2002
Anthony Mantha,265,85,91,176,0.664,171,RW/LW,2015,2021
Erik Haula,409,85,91,176,0.43,186,C/W,2013,2021
Sergei Kostitsyn,353,67,109,176,0.499,188,RW/LW,2007,2013
Richie Dunn,483,36,140,176,0.364,314,D,1977,1989
Anders Eriksson,572,22,154,176,0.308,242,D,1995,2010
Joe Malone,126,143,32,175,1.389,57,C,1917,1924
Tom Cook,349,77,98,175,0.501,184,C,1929,1938
Kent-Erik Andersson,456,72,103,175,0.384,78,F,1977,1984
Mac Colville,353,71,104,175,0.496,130,RW,1935,1947
Vladimir Konstantinov,446,47,128,175,0.392,838,D,1991,1997
Keith Ballard,605,38,137,175,0.289,612,D,2005,2015
Ed Kea,583,30,145,175,0.3,508,D,1973,1983
Nick Schultz,1066,30,145,175,0.16399999999999998,483,D,2001,2017
Shawn Matthias,551,90,84,174,0.316,180,LW,2007,2018
Stan Gilbertson,428,85,89,174,0.40700000000000003,148,LW,1971,1977
Alexander Semak,289,83,91,174,0.602,187,C,1991,1997
Derrick Smith,537,82,92,174,0.324,373,LW,1984,1994
Bryan Rust,313,79,95,174,0.556,104,RW/LW,2014,2021
Rick Dudley,309,75,99,174,0.563,292,LW,1972,1981
Tomas Kopecky,578,68,106,174,0.301,307,W/C,2005,2015
Jere Gillis,386,78,95,173,0.44799999999999995,230,LW,1977,1987
Craig Johnson,557,75,98,173,0.311,260,LW,1994,2004
Richard Kromm,372,70,103,173,0.465,138,LW,1983,1993
Craig Wolanin,695,40,133,173,0.249,894,D,1985,1998
Justin Braun,674,27,146,173,0.257,244,D,2010,2021
Harry Broadbent,305,121,51,172,0.564,564,RW,1918,1929
Marek Svatos,344,100,72,172,0.5,217,RW,2003,2011
Daniel Paille,582,85,87,172,0.29600000000000004,135,LW,2005,2016
Charley McVeigh,397,84,88,172,0.433,138,C/RW,1926,1935
Rick Hampton,337,59,113,172,0.51,147,D,1974,1980
Bob Manno,371,41,131,172,0.46399999999999997,274,D,1976,1985
Kenny Smith,331,78,93,171,0.517,49,LW,1944,1951
Casey Cizikas,538,74,97,171,0.318,237,C,2011,2021
Vladimir Sobotka,548,53,118,171,0.312,362,C/LW,2007,2020
Niclas Havelid,628,34,137,171,0.272,342,D,1999,2009
Gary Nylund,608,32,139,171,0.281,1235,D,1982,1993
Bob Goldham,650,28,143,171,0.263,400,D,1941,1956
Andreas Johansson,377,82,88,170,0.451,190,LW,1995,2004
Vladimir Tsyplakov,331,69,101,170,0.514,90,LW,1995,2001
Dmitri Kulikov,681,35,135,170,0.25,427,D,2009,2021
Fernando Pisani,462,87,82,169,0.366,200,RW,2002,2011
Rod Schutt,286,77,92,169,0.591,177,LW,1977,1986
Zach Werenski,305,58,111,169,0.5539999999999999,63,D,2016,2021
Ulf Nilsson,170,57,112,169,0.9940000000000001,85,C,1978,1983
Paul Baxter,472,48,121,169,0.358,1564,D,1979,1987
Jason Smith,1008,41,128,169,0.168,1099,D,1993,2009
Viktor Stalberg,488,82,86,168,0.344,245,LW/RW,2009,2017
Antti Laaksonen,483,81,87,168,0.348,152,LW,1998,2007
Ryan Dzingel,335,75,93,168,0.501,135,C/LW,2015,2021
Mike Craig,423,71,97,168,0.397,550,RW,1990,2002
Marcus Nilson,521,67,101,168,0.322,270,RW,1998,2008
Doug Hicks,561,37,131,168,0.299,442,D,1974,1983
Marek Malik,691,33,135,168,0.243,620,D,1994,2009
Carson Cooper,295,110,57,167,0.5660000000000001,111,RW,1924,1932
Vladimir Ruzicka,233,82,85,167,0.7170000000000001,129,C,1989,1994
Tim Taylor,746,73,94,167,0.22399999999999998,433,C,1993,2008
Ryan Spooner,325,48,119,167,0.514,63,C/LW,2012,2019
Alexei Gusarov,607,39,128,167,0.275,313,D,1990,2001
Niklas Hjalmarsson,786,25,142,167,0.212,318,D,2007,2021
Wildor Larochelle,474,92,74,166,0.35,211,RW,1925,1937
Brock Boeser,203,79,87,166,0.818,56,RW,2016,2021
Maurice Lemay,317,72,94,166,0.524,442,LW,1981,1989
Alan Kerr,391,72,94,166,0.425,826,RW,1984,1993
Bob Brooke,447,69,97,166,0.371,520,C,1983,1990
Alyn McCauley,488,69,97,166,0.34,116,C/LW,1997,2007
Riley Sheahan,518,67,99,166,0.32,83,C/LW,2011,2021
Newsy Lalonde,99,124,41,165,1.6669999999999998,183,C,1917,1927
Ab DeMarco,209,72,93,165,0.789,53,C,1938,1947
Larry Romanchych,298,68,97,165,0.5539999999999999,102,RW/C,1970,1977
Riley Nash,546,61,104,165,0.302,130,C/RW,2011,2021
Merlin Malinowski,282,54,111,165,0.585,121,C,1978,1983
Al Sims,475,49,116,165,0.34700000000000003,286,D,1973,1983
Jocelyn Lemieux,597,80,84,164,0.275,740,LW,1986,1998
Anthony Duclair,355,79,85,164,0.462,115,LW/RW,2014,2021
Phil Sykes,456,79,85,164,0.36,519,LW,1982,1992
Gary Jarrett,341,72,92,164,0.48100000000000004,131,LW,1960,1972
Trevor Lewis,678,70,94,164,0.242,171,C/W,2008,2021
Damon Severson,434,37,127,164,0.37799999999999995,266,D,2014,2021
Ric Nattress,536,29,135,164,0.306,377,D,1982,1993
Dave Burrows,724,29,135,164,0.22699999999999998,373,D,1971,1981
Tom Laidlaw,705,25,139,164,0.233,717,D,1980,1990
Joe Reekie,902,25,139,164,0.182,1326,D,1985,2002
Mattias Norstrom,903,18,146,164,0.182,661,D,1993,2008
Marc Habscheid,345,72,91,163,0.47200000000000003,171,C,1981,1992
Craig Patrick,401,72,91,163,0.406,61,RW,1971,1979
Erik Christensen,387,68,95,163,0.42100000000000004,162,C,2005,2012
Darius Kasparaitis,863,27,136,163,0.18899999999999997,1379,D,1992,2007
Sean McKenna,414,82,80,162,0.391,181,RW,1981,1990
Lorne Ferguson,422,82,80,162,0.384,193,LW,1949,1959
Joey Kocur,820,80,82,162,0.198,2519,RW,1984,1999
Leo Komarov,457,62,100,162,0.354,190,W/C,2012,2021
Victor Venasky,430,61,101,162,0.377,66,C,1972,1979
Eddie Wares,321,60,102,162,0.505,161,D/RW,1936,1947
Brett McLean,385,56,106,162,0.42100000000000004,204,C,2002,2009
Dmitri Kalinin,539,36,126,162,0.301,321,D,1999,2009
Dollard St-Laurent,652,29,133,162,0.248,496,D,1950,1962
Igor Ulanov,739,27,135,162,0.21899999999999997,1151,D,1991,2006
Ronnie Stern,638,75,86,161,0.252,2077,RW,1987,2000
Al McDonough,237,73,88,161,0.679,73,RW,1970,1978
Jordin Tootoo,723,65,96,161,0.223,1010,RW,2003,2017
Patrick O'Sullivan,334,58,103,161,0.48200000000000004,116,C,2006,2012
Clayton Keller,242,56,105,161,0.665,80,W/C,2016,2021
Boyd Gordon,706,56,105,161,0.228,149,C,2003,2017
David Savard,562,40,121,161,0.28600000000000003,309,D,2011,2021
Colton Parayko,390,39,122,161,0.413,111,D,2015,2021
Andrew MacDonald,586,28,133,161,0.275,276,D,2008,2019
Andreas Athanasiou,307,87,73,160,0.521,117,W/C,2015,2021
Timo Meier,268,77,83,160,0.597,158,LW/RW,2016,2021
Andy Blair,402,74,86,160,0.39799999999999996,323,C,1928,1937
Reg Kerr,263,66,94,160,0.608,169,LW,1977,1984
Patric Kjellberg,394,64,96,160,0.406,84,LW,1992,2003
Peter Mueller,297,63,97,160,0.539,98,C/W,2007,2013
Craig Adams,951,55,105,160,0.168,683,RW,2000,2015
Jason Garrison,555,49,111,160,0.28800000000000003,229,D,2008,2019
Kurtis Foster,405,42,118,160,0.395,308,D,2002,2013
Alexei Kasatonov,383,38,122,160,0.418,326,D,1989,1996
Pete Babando,351,86,73,159,0.45299999999999996,194,LW,1947,1953
Kevin Fiala,292,72,87,159,0.545,128,LW/RW,2014,2021
Pierre-Luc Dubois,239,66,93,159,0.665,164,C/LW,2017,2021
Craig Berube,1054,61,98,159,0.151,3149,LW,1986,2003
Glen Metropolit,407,57,102,159,0.391,148,C,1999,2010
Wally Boyer,365,54,105,159,0.436,163,C,1965,1972
Rostislav Klesla,654,48,111,159,0.243,620,D,2000,2014
Mark Reeds,365,45,114,159,0.436,135,RW,1981,1989
Jeff Beukeboom,804,30,129,159,0.198,1890,D,1985,1999
Chris Therien,764,29,130,159,0.20800000000000002,585,D,1994,2006
Brad Shaw,377,22,137,159,0.42200000000000004,208,D,1985,1999
Matt Beleskey,477,76,82,158,0.331,440,LW,2008,2019
Mike Leclerc,341,64,94,158,0.46299999999999997,288,LW,1996,2006
Joonas Donskoi,353,63,95,158,0.44799999999999995,92,RW/LW,2015,2021
Normand Rochefort,598,39,119,158,0.264,570,D,1980,1994
Kyle Quincey,586,36,122,158,0.27,548,D,2005,2018
Bob Woytowich,503,32,126,158,0.314,352,D,1964,1972
Ed Van Impe,700,27,131,158,0.226,1025,D,1966,1977
Cory Sarich,969,21,137,158,0.163,1089,D,1998,2014
Robert Murdoch,260,72,85,157,0.604,127,RW,1975,1979
Murray Balfour,306,67,90,157,0.513,393,RW,1956,1965
Ray Allison,237,64,93,157,0.662,223,C,1979,1987
Tom Kostopoulos,630,61,96,157,0.249,723,RW/LW,2001,2013
Carlo Colaiacovo,470,34,123,157,0.33399999999999996,231,D,2002,2016
Warren Godfrey,786,32,125,157,0.2,752,D,1952,1968
Gerry Couture,385,86,70,156,0.405,89,C,1944,1954
Adam Hall,682,69,87,156,0.22899999999999998,282,RW,2001,2014
Nate Thompson,771,62,94,156,0.20199999999999999,366,C/LW,2006,2021
Brian Cullen,326,56,100,156,0.479,92,C,1954,1961
Oscar Klefbom,378,34,122,156,0.413,74,D,2013,2021
Randy Ladouceur,931,30,126,156,0.168,1322,D,1982,1996
Zach Hyman,308,72,83,155,0.503,177,LW/RW,2015,2021
Real Lemieux,456,51,104,155,0.34,262,RW,1966,1974
Nick Schmaltz,254,48,107,155,0.61,52,C/RW,2016,2021
Michael Raffl,475,79,75,154,0.324,188,LW/RW,2013,2021
Mike Blaisdell,343,70,84,154,0.449,166,RW,1980,1989
Todd Warriner,453,65,89,154,0.34,249,LW,1994,2003
Yanni Gourde,257,64,90,154,0.599,175,C/W,2015,2021
Kevin Klein,627,38,116,154,0.24600000000000002,185,D,2005,2017
Pekka Rautakallio,235,33,121,154,0.655,122,D,1979,1982
Rick Zombo,652,24,130,154,0.23600000000000002,728,D,1984,1996
Jim Harrison,324,67,86,153,0.47200000000000003,435,C,1968,1980
Don Gallinger,222,65,88,153,0.6890000000000001,89,C,1942,1948
Dave Semenko,575,65,88,153,0.266,1175,LW,1979,1988
Matt Nieto,477,63,90,153,0.321,82,LW/RW,2013,2021
Floyd Thomson,411,56,97,153,0.37200000000000005,341,LW,1971,1980
Georges Laraque,695,53,100,153,0.22,1126,RW,1997,2010
Petr Cajanek,269,46,107,153,0.569,144,C,2002,2007
Chris Kotsopoulos,479,44,109,153,0.319,827,D,1980,1990
Craig Cameron,552,87,65,152,0.275,196,RW,1966,1976
Torrey Mitchell,666,67,85,152,0.228,351,C/RW,2007,2018
Yuri Khmylyov,263,64,88,152,0.578,133,LW,1992,1997
Red Horner,490,42,110,152,0.31,1254,D,1928,1940
Adam Burt,737,37,115,152,0.20600000000000002,961,D,1988,2001
Jaccob Slavin,380,29,123,152,0.4,58,D,2015,2021
Barry Wilkins,418,27,125,152,0.364,663,D,1966,1976
Bryan Watson,878,17,135,152,0.17300000000000001,2212,D,1963,1979
Billy MacMillan,446,74,77,151,0.33899999999999997,184,C,1970,1977
Conor Sheary,328,72,79,151,0.46,66,LW/RW,2015,2021
Kris King,849,66,85,151,0.17800000000000002,2030,LW,1987,2001
Pavel Buchnevich,251,61,90,151,0.602,70,RW/LW,2016,2021
Nils Ekman,264,60,91,151,0.5720000000000001,188,LW,1999,2007
Rudy Migay,418,59,92,151,0.361,293,C,1949,1960
Kevin Labanc,289,51,100,151,0.522,132,RW/LW,2016,2021
Aaron Ward,839,44,107,151,0.18,736,D,1993,2010
Chris Joseph,510,39,112,151,0.29600000000000004,567,D,1987,2001
Jamie Baker,404,71,79,150,0.371,271,C,1989,1999
Andy Sutton,676,38,112,150,0.222,1185,D,1998,2013
Dale Rolfe,509,25,125,150,0.295,556,D,1959,1975
Tyler Wright,613,79,70,149,0.243,854,C,1992,2006
Matt Bradley,675,59,90,149,0.221,562,RW/LW,2000,2012
Drake Berehowsky,549,37,112,149,0.271,848,D,1990,2004
Francis Bouillon,776,32,117,149,0.192,536,D,1999,2014
Sandy McCarthy,736,72,76,148,0.201,1534,RW,1993,2004
Nathan Gerbe,426,62,86,148,0.34700000000000003,194,C/W,2008,2021
Ville Peltonen,382,52,96,148,0.387,119,LW,1995,2009
Torrie Robertson,442,49,99,148,0.335,1751,LW,1980,1990
Kent Douglas,428,33,115,148,0.34600000000000003,631,D,1962,1969
Jonas Brodin,560,31,117,148,0.264,164,D,2012,2021
Luke Schenn,761,31,117,148,0.19399999999999998,573,D,2008,2021
Fred Barrett,745,25,123,148,0.19899999999999998,671,D,1970,1984
Guillaume Latendresse,341,87,60,147,0.431,185,LW/RW,2006,2013
Warren Young,236,72,75,147,0.623,472,LW,1981,1988
Red Beattie,334,62,85,147,0.44,137,LW,1930,1939
Jesper Fast,425,55,92,147,0.34600000000000003,116,RW,2013,2021
Doug Roberts,419,43,104,147,0.35100000000000003,342,D/RW,1965,1975
Daniil Markov,538,29,118,147,0.273,456,D,1997,2007
Craig Muni,819,28,119,147,0.179,775,D,1981,1998
Corb Denneny,176,103,43,146,0.83,148,C,1917,1928
Ron Delorme,524,83,63,146,0.27899999999999997,667,RW,1976,1985
Petr Prucha,346,78,68,146,0.42200000000000004,133,RW/LW,2005,2011
Lindsay Carson,373,66,80,146,0.391,624,LW,1981,1988
Glen Harmon,452,50,96,146,0.32299999999999995,334,D,1942,1951
Mark Lamb,403,46,100,146,0.36200000000000004,291,C,1985,1996
Chris Campoli,440,35,111,146,0.332,200,D,2005,2012
Bob Plager,644,20,126,146,0.22699999999999998,802,D,1964,1978
Jeff Odgers,821,75,70,145,0.177,2364,RW,1991,2003
Gary Lupul,293,70,75,145,0.495,243,C,1979,1986
Peter Sundstrom,335,61,84,145,0.433,122,LW,1983,1990
Connor Brown,328,59,86,145,0.442,70,RW,2015,2021
Jim Nill,524,58,87,145,0.27699999999999997,854,RW,1981,1990
Brett Callighen,160,56,89,145,0.9059999999999999,132,C,1979,1982
Matti Hagman,237,56,89,145,0.612,36,C,1976,1982
Ralph Klassen,497,52,93,145,0.292,120,C,1975,1984
Kerry Huffman,401,37,108,145,0.36200000000000004,361,D,1986,1996
Scott Bjugstad,317,76,68,144,0.45399999999999996,144,RW,1983,1992
Joe Benoit,185,75,69,144,0.778,94,RW,1940,1947
Dan Labraaten,268,71,73,144,0.537,47,LW/RW,1978,1982
Nick Boynton,605,34,110,144,0.23800000000000002,862,D,1999,2011
Hank Goldup,202,63,80,143,0.708,97,LW,1939,1946
Tommy Wingels,448,62,81,143,0.319,254,C/W,2010,2018
Colton Sceviour,459,61,82,143,0.312,108,C/W,2010,2021
Roland Eriksson,193,48,96,143,0.741,26,C,1976,1979
Bengt Lundholm,275,48,95,143,0.52,72,LW,1981,1986
Deron Quint,463,46,97,143,0.309,166,D,1995,2007
Scott Lachance,819,31,112,143,0.175,567,D,1991,2004
Harry Cameron,128,88,54,142,1.109,183,D/F,1917,1923
Bob Crawford,246,71,71,142,0.5770000000000001,72,RW,1979,1987
Cody Hodgson,328,64,78,142,0.433,68,C,2010,2016
Alexander Korolyuk,296,62,80,142,0.48,140,RW/LW,1997,2004
Jarkko Ruutu,652,58,84,142,0.218,1078,LW,1999,2011
Jon Klemm,773,42,100,142,0.184,436,D,1991,2008
Henrik Tallinder,678,28,114,142,0.209,378,D,2001,2014
Tim Gleason,727,17,125,142,0.195,701,D,2003,2015
Steve Christoff,248,77,64,141,0.569,108,C,1979,1984
Sylvio Mantha,542,63,78,141,0.26,671,D,1923,1937
Hartland Monahan,334,61,80,141,0.42200000000000004,163,LW,1973,1981
Dennis Polonich,390,59,82,141,0.36200000000000004,1242,C,1974,1983
Jan Ludvig,314,54,87,141,0.449,418,F,1982,1989
Nick Holden,496,45,96,141,0.284,150,D,2010,2021
Germain Gagnon,259,40,101,141,0.544,72,LW,1971,1976
Nate Schmidt,402,30,111,141,0.35100000000000003,84,D,2013,2021
Gilbert Dionne,223,61,79,140,0.628,108,LW,1990,1996
Lou Franceschetti,459,59,81,140,0.305,747,RW,1981,1992
Normand Dupont,256,55,85,140,0.547,52,LW,1979,1984
Dick Tarnstrom,306,35,105,140,0.45799999999999996,254,D,2001,2008
Frantisek Musil,797,34,106,140,0.17600000000000002,1241,D,1986,2001
Roman Polak,806,26,114,140,0.174,643,D,2006,2020
Karel Rachunek,371,22,118,140,0.377,227,D,1999,2008
Jon Sim,469,75,64,139,0.29600000000000004,314,LW,1998,2011
Norm Ferguson,279,73,66,139,0.498,72,C,1968,1972
Maxim Lapierre,614,65,74,139,0.226,586,C,2005,2015
Pat Conacher,521,63,76,139,0.267,235,LW,1979,1996
Tobias Rieder,439,60,79,139,0.317,50,C/W,2014,2021
Steve Ludzik,424,46,93,139,0.32799999999999996,333,C,1981,1990
Darryl Shannon,544,28,111,139,0.256,523,D,1988,2001
Keith Magnuson,589,14,125,139,0.23600000000000002,1442,D,1969,1980
Sprague Cleghorn,259,83,55,138,0.5329999999999999,538,D,1918,1928
Michel Bergeron,229,80,58,138,0.603,165,RW,1974,1979
Jordy Douglas,268,76,62,138,0.515,169,F,1979,1985
John Wensink,403,70,68,138,0.342,842,LW,1973,1983
Oliver Bjorkstrand,251,67,71,138,0.55,54,RW,2015,2021
Jim Slater,584,67,71,138,0.23600000000000002,407,C,2005,2015
Sven Bartschi,291,66,72,138,0.474,78,LW,2011,2020
Mike Santorelli,406,64,74,138,0.34,78,C,2008,2016
Randy Pierce,277,62,76,138,0.498,223,RW,1977,1985
Tim Hunter,815,62,76,138,0.16899999999999998,3146,D/RW,1981,1997
Zemgus Girgensons,489,61,77,138,0.282,130,C/W,2013,2021
Denis Arkhipov,352,56,82,138,0.392,128,C,2000,2007
Tim Sweeney,291,55,83,138,0.474,123,LW,1990,1998
Marc Bureau,567,55,83,138,0.243,327,C,1989,2000
Bobby Dollas,645,42,96,138,0.214,467,D,1983,2001
Kevin Haller,642,41,97,138,0.215,907,D,1989,2002
Noah Hanifin,392,28,110,138,0.35200000000000004,97,D,2015,2021
Ian Cole,545,26,112,138,0.253,507,D,2010,2021
Lars Lindgren,394,25,113,138,0.35,325,D,1978,1984
Jakub Vrana,250,68,69,137,0.5479999999999999,61,LW/RW,2016,2021
Eric Lacroix,472,67,70,137,0.29,361,LW,1993,2001
Gino Odjick,604,61,73,137,0.22699999999999998,2567,LW,1990,2002
Nick Fotiu,646,60,77,137,0.212,1362,LW,1976,1989
Jay Beagle,589,56,81,137,0.233,217,C,2008,2021
Oleg Saprykin,325,55,82,137,0.42200000000000004,240,LW,1999,2007
Marco Scandella,583,42,95,137,0.235,233,D,2010,2021
Carl Gunnarsson,619,30,107,137,0.221,175,D,2009,2021
Bryan Bickell,395,66,70,136,0.344,192,LW,2006,2017
Nail Yakupov,350,62,74,136,0.389,142,RW/LW,2012,2018
Jim Campbell,285,61,75,136,0.47700000000000004,268,RW,1995,2006
Perry Berezan,378,61,75,136,0.36,277,C,1984,1993
Kevyn Adams,540,59,77,136,0.252,317,C,1997,2008
Travis Moen,747,59,77,136,0.182,801,LW/RW,2003,2016
Wayne Maki,246,57,79,136,0.5529999999999999,184,LW,1967,1973
Mike Sullivan,709,54,82,136,0.192,203,C,1991,2002
Basil McRae,576,53,83,136,0.23600000000000002,2453,LW,1981,1997
Derek Ryan,305,51,85,136,0.446,88,C/RW,2015,2021
Mike Hudson,416,49,87,136,0.327,414,C,1988,1997
Larry Regan,280,41,95,136,0.486,71,F,1956,1961
Karlis Skrastins,832,32,104,136,0.163,375,D,1998,2011
Bryan Allen,721,29,107,136,0.18899999999999997,839,D,2000,2015
Dean Kennedy,717,26,110,136,0.19,1118,D,1982,1995
Jesse Belanger,246,59,76,135,0.5489999999999999,56,C,1991,2001
Glenn Brydson,299,56,79,135,0.452,203,RW,1930,1938
Ron Zanussi,299,52,83,135,0.452,373,RW,1977,1982
Nico Hischier,209,51,84,135,0.6459999999999999,62,C,2017,2021
Doug Evans,355,48,87,135,0.38,502,LW,1985,1993
Ivan Provorov,320,44,91,135,0.42200000000000004,112,D,2016,2021
Shea Theodore,269,39,96,135,0.502,91,D,2015,2021
Jan Hejda,627,25,110,135,0.215,317,D,2006,2015
George Hay,239,74,60,134,0.561,84,LW,1926,1934
Nelson Pyatt,296,71,63,134,0.45299999999999996,69,C,1973,1980
Micheal Ferland,335,60,74,134,0.4,200,LW/RW,2014,2021
Rostislav Olesz,365,57,77,134,0.36700000000000005,118,LW/RW,2005,2014
Chris Thorburn,801,53,81,134,0.16699999999999998,968,RW,2005,2019
Jack Egers,284,64,69,133,0.46799999999999997,154,RW,1969,1976
Gus Marker,322,64,69,133,0.413,133,RW,1932,1942
Kyle Clifford,679,62,71,133,0.196,844,LW,2010,2021
Elias Pettersson,145,55,78,133,0.917,34,C,2018,2021
Karl Dykhuis,644,42,91,133,0.207,495,D,1991,2004
Anton Volchenkov,696,19,114,133,0.191,438,D,2002,2015
Ed Slowinski,291,58,74,132,0.45399999999999996,63,RW,1947,1953
Rene Corbet,362,58,74,132,0.365,420,LW,1993,2001
Tom Preissing,326,31,101,132,0.405,78,D,2003,2010
Brent Hughes,435,15,117,132,0.303,440,D,1967,1975
Billy Boucher,213,93,38,131,0.615,409,RW,1921,1928
Bill Lochead,330,69,72,131,0.397,180,RW,1974,1980
Matt Martin,696,61,70,131,0.188,948,LW,2009,2021
Cory Cross,659,34,97,131,0.19899999999999998,684,D,1993,2006
Steve Montador,571,33,98,131,0.22899999999999998,807,D,2001,2012
Jack O'Callahan,389,27,104,131,0.337,541,D,1982,1989
Pierre Lacroix,274,24,107,131,0.478,197,D,1979,1983
Pat Quinn,606,18,113,131,0.21600000000000003,950,D,1968,1977
Ralph Stewart,252,57,73,130,0.516,28,C,1970,1978
Jiri Hrdina,250,45,85,130,0.52,92,C,1987,1992
Larry Cahan,666,38,92,130,0.195,700,D,1954,1971
Jack Lynch,382,24,106,130,0.34,336,D,1972,1979
Gary Doak,789,23,107,130,0.165,908,D,1965,1981
Karl Alzner,686,20,110,130,0.19,219,D,2008,2020
Tom Reid,701,17,113,130,0.185,654,D,1967,1978
Odie Cleghorn,181,95,34,129,0.713,142,RW,1918,1928
Darby Hendrickson,518,65,64,129,0.249,370,C,1993,2004
Ben Clymer,438,52,77,129,0.295,367,RW/D,1999,2007
Murray Baron,988,35,94,129,0.131,1309,D,1989,2004
Mike Van Ryn,353,30,99,129,0.365,260,D,2000,2009
Trent Yawney,593,27,102,129,0.218,783,D,1987,1999
Colin White,797,21,108,129,0.162,869,D,1999,2012
Hib Milks,317,87,41,128,0.40399999999999997,179,F,1925,1933
Bill Sutherland,250,70,58,128,0.512,99,C,1962,1972
Anthony Beauvillier,290,66,62,128,0.441,49,LW,2016,2021
Dave Forbes,363,64,64,128,0.353,341,LW,1973,1979
Sam Bennett,367,63,65,128,0.349,304,C/W,2014,2021
Radek Faksa,352,60,68,128,0.364,217,C,2015,2021
Denis Pederson,435,57,71,128,0.294,398,C,1995,2003
Wayne Carleton,278,55,73,128,0.46,172,LW,1965,1972
Mats Lindgren,387,54,74,128,0.331,146,C,1996,2003
Erik Rasmussen,545,52,76,128,0.235,305,C,1997,2007
Bob Stewart,575,27,101,128,0.223,809,D,1971,1980
Colin Campbell,636,25,103,128,0.201,1292,D,1974,1985
Mike Robitaille,382,23,105,128,0.335,280,D,1969,1977
Adam Larsson,553,22,106,128,0.231,327,D,2011,2021
Noel Price,499,14,114,128,0.257,333,D,1957,1976
Regis Kelly,288,74,53,127,0.441,105,RW,1934,1942
Cody McLeod,775,72,55,127,0.16399999999999998,1628,LW,2007,2019
Kris Manery,250,63,64,127,0.508,91,RW,1977,1981
Scott Nichol,662,56,71,127,0.192,916,C,1995,2013
Derek Dorsett,515,51,76,127,0.247,1314,RW,2008,2019
Cody Ceci,498,33,94,127,0.255,110,D,2013,2021
Deryk Engelland,671,30,97,127,0.18899999999999997,579,D,2009,2020
Dave Farrish,430,17,110,127,0.295,440,D,1976,1984
John Sheppard,308,68,58,126,0.409,224,LW,1926,1934
Eddie Kullman,343,56,70,126,0.36700000000000005,298,F,1947,1954
Jared McCann,315,53,73,126,0.4,116,C/LW,2015,2021
Paul Lawless,239,49,77,126,0.527,54,LW,1982,1990
Niko Kapanen,397,36,90,126,0.317,160,C,2001,2008
Hannu Virta,245,25,101,126,0.514,66,D,1981,1986
Randy Hillier,543,16,110,126,0.23199999999999998,906,D,1981,1992
Jack Adams,173,81,44,125,0.723,372,C,1917,1927
Steven Rice,329,64,61,125,0.38,275,RW,1990,1998
Russ Blinco,268,59,66,125,0.466,24,C,1933,1939
Adam Lowry,412,59,66,125,0.303,215,C,2014,2021
Dale Weise,513,55,70,125,0.244,355,RW,2010,2020
Derek MacKenzie,611,51,74,125,0.205,337,C/LW,2001,2019
Vic Lynn,327,49,76,125,0.382,274,LW,1942,1954
Yannick Tremblay,390,38,87,125,0.321,178,D,1996,2007
Jonathan Ericsson,680,27,98,125,0.184,535,D,2007,2020
Jay McKee,802,21,104,125,0.156,622,D,1995,2010
Magnus Paajarvi,467,62,62,124,0.266,78,LW/RW,2010,2019
Lane Lambert,283,58,66,124,0.43799999999999994,521,RW,1983,1989
Dave Archibald,323,57,67,124,0.384,139,RW,1987,1997
Gerry Pinder,223,55,69,124,0.556,135,LW,1969,1972
John-Paul Kelly,400,54,70,124,0.31,366,LW,1979,1986
Andrei Nazarov,571,53,71,124,0.217,1409,LW,1993,2006
Nick Spaling,437,52,72,124,0.284,120,C/LW,2009,2016
"Ab DeMarco, Jr.",344,44,80,124,0.36,75,D,1969,1979
David Maley,466,43,81,124,0.266,1043,LW/C,1985,1994
Jamie Heward,394,38,86,124,0.315,221,D,1995,2009
Darryl Edestrand,455,34,90,124,0.273,404,D,1967,1979
Michael Stone,472,31,93,124,0.263,264,D,2011,2021
Olli Maatta,431,29,95,124,0.28800000000000003,120,D,2013,2021
Josh Gorges,783,17,107,124,0.158,404,D,2005,2018
Eric Nystrom,593,75,48,123,0.207,401,LW,2005,2016
Leroy Goldsworthy,336,66,57,123,0.366,79,RW,1928,1939
Matt Pettinger,422,65,58,123,0.29100000000000004,210,LW,2000,2010
Mike Crombeen,475,55,68,123,0.259,218,RW,1977,1985
Chris Kontos,230,54,69,123,0.535,103,LW,1982,1993
Nikolai Borschevsky,162,49,74,123,0.759,44,RW,1992,1996
Ronald Lalonde,397,45,78,123,0.31,106,F,1972,1979
Ivan Hlinka,137,42,81,123,0.898,28,C,1981,1983
Marcus Kruger,520,38,85,123,0.237,234,C,2010,2019
Bucko McDonald,446,35,88,123,0.276,206,D,1934,1945
Gilbert Delorme,541,31,92,123,0.22699999999999998,520,D,1981,1990
Darnell Nurse,356,30,93,123,0.34600000000000003,301,D,2014,2021
Danny DeKeyser,446,29,94,123,0.276,228,D,2012,2021
Gord Kluzak,299,25,98,123,0.41100000000000003,543,D,1982,1991
Marc Methot,624,22,101,123,0.19699999999999998,380,D,2006,2019
Drew Miller,571,62,60,122,0.214,136,LW/RW,2006,2017
Rocky Saganiuk,259,57,65,122,0.47100000000000003,201,RW,1978,1984
Bill Berg,546,55,67,122,0.223,488,D,1988,1999
Tyler Bertuzzi,204,50,72,122,0.598,119,LW/RW,2016,2021
Mike Kaszycki,226,42,80,122,0.54,108,F,1977,1983
Len Lunde,321,39,83,122,0.38,75,LW,1958,1971
Ryan Johnson,701,38,84,122,0.174,250,C,1997,2011
Dennis O'Brien,592,31,91,122,0.20600000000000002,1017,D,1970,1980
Erik Gustafsson,226,28,94,122,0.54,71,D,2015,2021
Bob Hess,329,27,95,122,0.371,178,D,1974,1984
Ken Reardon,341,26,96,122,0.358,604,D,1940,1950
Brandon Pirri,276,72,49,121,0.43799999999999994,91,C/W,2010,2021
Billy Dea,397,67,54,121,0.305,44,C,1953,1971
Peter Douris,321,54,67,121,0.377,80,RW,1985,1998
Richard Lemieux,274,39,82,121,0.442,132,C,1971,1976
Thomas Chabot,209,30,91,121,0.579,96,D,2016,2021
Tim Bothwell,502,28,93,121,0.24100000000000002,382,D,1978,1989
Radko Gudas,481,26,95,121,0.252,619,D,2012,2021
Jean Hamel,699,26,95,121,0.17300000000000001,766,D,1972,1984
Brendan Witt,890,25,96,121,0.136,1424,D,1995,2010
Janne Laukkanen,407,22,99,121,0.297,335,D,1994,2003
Russ Anderson,519,22,99,121,0.233,1086,D,1976,1985
Ken Randall,219,69,51,120,0.5479999999999999,581,D,1917,1927
Jake DeBrusk,207,62,58,120,0.58,51,LW/RW,2017,2021
Branko Radivojevic,399,52,68,120,0.301,252,RW,2001,2008
Christian Dvorak,251,51,69,120,0.478,62,C/LW,2016,2021
Brad Dalgarno,321,49,71,120,0.374,332,RW,1985,1996
Nick Harbaruk,364,45,75,120,0.33,273,RW,1969,1974
Andrei Zyuzin,496,38,82,120,0.242,446,D,1997,2008
Richard Mulhern,303,27,93,120,0.396,217,D,1975,1981
Larry Playfair,688,26,94,120,0.174,1814,D,1978,1990
Vladimir Orszagh,289,54,65,119,0.41200000000000003,194,RW,1997,2006
Landon Wilson,375,53,66,119,0.317,352,RW,1995,2009
Glenn Goldup,291,52,67,119,0.409,303,F,1973,1982
Troy Mallette,456,51,68,119,0.261,1226,LW,1989,1998
Peter Marsh,278,48,71,119,0.428,224,RW,1979,1984
Alf Pike,234,42,77,119,0.509,145,F,1939,1947
Ville Leino,286,40,79,119,0.41600000000000004,70,LW/RW,2008,2014
Matt Hunwick,535,25,94,119,0.222,207,D,2007,2020
Aaron Miller,677,25,94,119,0.17600000000000002,422,D,1993,2008
Frantisek Kucera,465,24,95,119,0.256,251,D,1990,2002
Christopher Tanev,517,22,97,119,0.23,121,D,2010,2021
Dave Langevin,513,12,107,119,0.23199999999999998,530,D,1979,1987
Josh Anderson,272,68,50,118,0.434,218,RW/LW,2014,2021
John Stewart,258,58,60,118,0.457,158,LW,1970,1975
Danton Cole,318,58,60,118,0.371,125,RW,1989,1996
Louis Trudel,306,49,69,118,0.386,122,LW,1933,1941
Armand Mondou,386,47,71,118,0.306,99,LW,1928,1940
Glen Currie,326,39,79,118,0.36200000000000004,100,LW,1979,1988
Robert Nilsson,252,37,81,118,0.46799999999999997,90,LW,2005,2010
Brian Pothier,362,26,92,118,0.326,202,D,2000,2010
Jiri Bubla,256,17,101,118,0.461,202,D,1981,1986
Harold Darragh,308,68,49,117,0.38,50,RW,1925,1933
Brit Selby,350,55,62,117,0.33399999999999996,163,LW,1964,1972
Ville Nieminen,385,48,69,117,0.304,333,LW/RW,1999,2007
Duane Rupp,374,24,93,117,0.313,220,D,1962,1973
Jordie Benn,517,23,94,117,0.226,213,D,2011,2021
Kjell Dahlin,166,57,59,116,0.6990000000000001,77,F,1985,1988
Joel Armia,300,57,59,116,0.387,98,RW,2014,2021
Matt Hendricks,607,54,62,116,0.191,722,LW/C,2008,2019
Michel Ouellet,190,52,64,116,0.611,58,RW,2005,2009
Alexander Kerfoot,228,44,72,116,0.509,100,C/LW,2017,2021
Gordon Pettinger,292,42,74,116,0.397,77,C,1932,1940
Gerry Melnyk,269,39,77,116,0.431,34,C,1955,1968
Brenden Dillon,603,23,93,116,0.192,583,D,2011,2021
Dave Hutchison,584,19,97,116,0.19899999999999998,1550,D,1974,1984
Mike Christie,412,15,101,116,0.282,550,D,1974,1981
Kari Eloranta,267,13,103,116,0.434,155,D,1981,1987
James Black,352,58,57,115,0.327,84,C,1989,2001
Randy Gilhen,457,55,60,115,0.252,314,LW,1982,1996
Bill McCreary,309,53,62,115,0.37200000000000005,108,LW,1953,1971
Normand Lacombe,319,53,62,115,0.361,196,RW,1984,1991
Dunc Fisher,275,45,70,115,0.418,104,RW,1947,1959
Brandon Prust,486,40,75,115,0.237,1036,LW/RW,2006,2016
John Moore,532,38,77,115,0.21600000000000003,222,D,2010,2021
Jack Stewart,565,31,84,115,0.204,765,D,1938,1952
Dennis Owchar,288,30,85,115,0.39899999999999997,200,D,1974,1980
Darren Van Impe,411,25,90,115,0.28,397,D,1994,2003
Thomas Hickey,449,22,93,115,0.256,190,D,2012,2021
Jimmy Herberts,206,83,31,114,0.5529999999999999,253,C,1924,1930
Mickey Roach,211,77,37,114,0.54,52,F,1919,1927
Nick Ritchie,298,46,68,114,0.38299999999999995,352,LW,2015,2021
Bob Girard,305,45,69,114,0.374,140,LW,1975,1980
Joe Colborne,295,42,72,114,0.386,144,C/W,2010,2017
Adam Mair,615,38,76,114,0.185,829,RW,1998,2011
David Tanabe,449,30,84,114,0.254,245,D,1999,2008
Mike Pelyk,441,26,88,114,0.259,566,D,1967,1978
Tracy Pratt,580,17,97,114,0.19699999999999998,1026,D,1967,1977
Brian Glennie,572,14,100,114,0.19899999999999998,621,D,1969,1979
Frank Vatrano,276,66,47,113,0.409,130,C/W,2015,2021
Mark Kirton,266,57,56,113,0.425,121,C,1979,1985
David Silk,249,54,59,113,0.45399999999999996,271,RW,1979,1986
Hnat Domenichelli,267,52,61,113,0.423,104,LW,1996,2003
Mark Janssens,711,40,73,113,0.159,1422,C,1987,2001
Lars Molin,172,33,80,113,0.657,37,C,1981,1984
Brady Skjei,317,25,88,113,0.35600000000000004,180,D,2015,2021
Brad Lukowich,658,23,90,113,0.172,369,D,1997,2011
Luca Sbisa,548,20,93,113,0.20600000000000002,385,D,2008,2021
Gord Lane,539,19,94,113,0.21,1228,D,1975,1985
Jack Darragh,121,66,46,112,0.9259999999999999,110,RW,1917,1924
Jimmy Vesey,310,61,51,112,0.361,84,LW/RW,2016,2021
Melker Karlsson,396,60,52,112,0.28300000000000003,130,RW/C,2014,2020
Andrew Copp,360,46,66,112,0.311,56,C/LW,2014,2021
Steven Finn,725,34,78,112,0.154,1724,D,1985,1997
Art Coulter,465,30,82,112,0.24100000000000002,543,D,1931,1942
Bob Lorimer,529,22,90,112,0.212,431,D,1976,1986
Albert Langlois,497,21,91,112,0.225,488,D,1957,1966
Bert Corbeau,258,63,48,111,0.43,664,D,1917,1927
Steve Atkinson,302,60,51,111,0.368,122,RW,1968,1975
Tom Gorence,303,58,53,111,0.366,89,RW,1978,1984
Ryan Hartman,319,52,59,111,0.348,287,RW/LW,2014,2021
Luke Glendening,505,51,60,111,0.22,176,C/RW,2013,2021
Bobby Sheehan,310,48,63,111,0.358,40,C,1969,1982
Lubos Bartecko,257,46,65,111,0.43200000000000005,107,LW,1998,2003
Doug Robinson,239,44,67,111,0.46399999999999997,34,LW,1963,1971
Brad Lauer,323,44,67,111,0.344,218,LW,1986,1996
Jori Lehtera,307,34,77,111,0.36200000000000004,167,C,2014,2019
Espen Knutsen,207,30,81,111,0.536,105,C,1997,2004
Jassen Cullimore,812,26,85,111,0.13699999999999998,704,D,1994,2011
Wally Stanowski,428,23,88,111,0.259,160,D,1939,1951
Mario Faubert,231,21,90,111,0.48100000000000004,222,D,1974,1982
Ron Harris,476,20,91,111,0.233,474,D,1962,1976
Nick Beverley,501,18,93,111,0.222,156,D,1966,1980
Rob Pearson,269,56,54,110,0.409,645,RW,1991,1997
Mattias Janmark,302,47,63,110,0.364,76,C/W,2015,2021
Alex Tuch,205,45,65,110,0.537,49,RW,2016,2021
Mark Taylor,209,42,68,110,0.526,73,C,1981,1986
Jamie McBain,348,30,80,110,0.316,72,D,2009,2017
Paul Boutilier,288,27,83,110,0.382,358,D,1981,1989
Radek Martinek,486,25,85,110,0.226,280,D,2001,2014
Bryce Salvador,786,25,86,110,0.14,696,D,2000,2015
Josh Morrissey,292,24,86,110,0.377,125,D,2015,2021
Colin Miller,306,23,87,110,0.359,215,D,2015,2021
Ryan Murray,351,15,95,110,0.313,104,D,2013,2021
Robert Palmer,320,9,101,110,0.344,115,D,1977,1984
Rob Scuderi,783,8,102,110,0.14,198,D,2003,2016
Wayne Bianchin,276,68,41,109,0.395,137,LW,1973,1980
Steve Begin,524,57,52,109,0.20800000000000002,561,C,1997,2013
Artturi Lehkonen,296,55,54,109,0.368,86,LW/RW,2016,2021
Jimmy Hayes,334,54,55,109,0.326,149,RW/C,2011,2018
Dwight King,365,53,56,109,0.299,98,LW/RW,2010,2017
Brian Willsie,381,52,57,109,0.28600000000000003,217,RW,1999,2011
Perry Anderson,417,50,59,109,0.261,1051,LW,1981,1992
Wayne Dillon,229,43,66,109,0.47600000000000003,60,C,1975,1980
Nevin Markwart,309,41,68,109,0.353,794,LW,1983,1992
Dylan Strome,169,37,72,109,0.645,46,C/W,2016,2021
Mikko Leinonen,162,31,78,109,0.6729999999999999,71,C,1981,1985
Ryan Pulock,238,31,78,109,0.45799999999999996,55,D,2015,2021
Leo Reise Jr.,494,28,81,109,0.221,399,D,1945,1954
Scott Laughton,326,44,64,108,0.331,178,C/LW,2012,2021
Serge Aubin,374,44,64,108,0.289,361,C/LW,1998,2006
Steve Patrick,250,40,68,108,0.43200000000000005,242,RW,1980,1986
Danton Heinen,234,37,71,108,0.462,44,W/C,2016,2021
Pavel Zacha,270,37,71,108,0.4,78,C/LW,2015,2021
Al Dewsbury,347,30,78,108,0.311,365,D,1946,1956
Reg Hamilton,424,21,87,108,0.255,412,D,1935,1947
Matt D'Agostini,321,52,55,107,0.33299999999999996,147,RW/LW,2007,2014
Norman Gainor,246,51,56,107,0.435,129,C,1927,1935
Sheldon Kennedy,310,49,58,107,0.345,233,RW,1989,1997
Bill Lesuk,388,44,63,107,0.276,368,LW,1968,1980
Devin Shore,293,40,67,107,0.365,51,C,2015,2021
Cy Wentworth,575,39,68,107,0.18600000000000003,355,D,1927,1940
Anton Babchuk,289,36,71,107,0.37,108,D,2003,2013
Bob Beers,258,28,79,107,0.415,225,D,1989,1997
Mikhail Sergachyov,231,25,82,107,0.46299999999999997,126,D,2016,2021
Alain Daigle,389,56,50,106,0.272,122,RW,1974,1980
Stephane Veilleux,506,50,56,106,0.209,348,LW,2002,2015
Gord Labossiere,215,44,62,106,0.493,75,C,1963,1972
Bryan Campbell,260,35,71,106,0.408,74,C,1967,1972
Paul Ranger,323,24,82,106,0.32799999999999996,254,D,2005,2014
Pierre Bouchard,595,24,82,106,0.17800000000000002,433,D,1970,1982
Rhett Warrener,714,24,82,106,0.14800000000000002,899,D,1995,2008
Mike Commodore,484,23,83,106,0.21899999999999997,683,D,2000,2012
Gord Dineen,528,16,90,106,0.201,693,D,1982,1995
Greg Fox,494,14,92,106,0.215,637,D,1977,1985
Bill Touhey,280,65,40,105,0.375,107,LW,1927,1934
Rob Gaudreau,231,51,54,105,0.455,69,RW/D,1992,1996
Calum MacKay,237,50,55,105,0.44299999999999995,214,LW,1946,1955
Robby Fabbri,218,47,58,105,0.48200000000000004,78,C/W,2015,2021
T.J. Galiardi,321,44,61,105,0.327,136,C/LW,2008,2015
Adrian Kempe,260,43,62,105,0.40399999999999997,138,C/W,2016,2021
Jim Vandermeer,461,25,80,105,0.228,664,D,2002,2012
Tony DeAngelo,202,24,81,105,0.52,176,D,2016,2021
Randy Jones,365,20,85,105,0.28800000000000003,185,D,2003,2012
Ken Morrow,550,17,88,105,0.191,309,D,1979,1989
Mike Lalor,687,17,88,105,0.153,677,D,1985,1997
Rosie Couture,309,48,56,104,0.337,184,RW,1928,1936
Fredrik Sjostrom,489,46,58,104,0.213,190,LW,2003,2011
Jordan Martinook,377,43,61,104,0.276,163,W/C,2014,2021
Andrei Lomakin,215,42,62,104,0.484,92,LW,1991,1995
Andy Hilbert,307,42,62,104,0.33899999999999997,132,C,2001,2011
Kent Manderville,646,37,67,104,0.161,348,C,1991,2003
Carl Voss,261,34,70,104,0.39799999999999996,50,C,1926,1938
Eric Perrin,245,32,72,104,0.424,92,C,2003,2009
Kyle Chipchura,481,31,73,104,0.21600000000000003,376,C/W,2007,2016
Lou Fontinato,535,26,78,104,0.19399999999999998,1247,D,1954,1963
Brian Glynn,431,25,79,104,0.24100000000000002,410,D,1987,1997
Doug Barkley,253,24,80,104,0.41100000000000003,382,D,1957,1966
Wayne Hillman,691,18,86,104,0.151,534,D,1960,1973
Andrei Svechnikov,153,47,56,103,0.6729999999999999,118,RW/LW,2018,2021
Rolf Edberg,184,45,58,103,0.56,24,C,1978,1981
Robert Fillion,327,42,61,103,0.315,84,LW,1943,1950
Alex Iafallo,231,41,62,103,0.446,48,LW/C,2017,2021
Gabriel Bourque,413,40,63,103,0.249,75,LW/RW,2011,2020
Alex Motter,255,39,64,103,0.40399999999999997,135,C,1934,1943
Christian Bordeleau,205,38,65,103,0.502,82,C,1968,1972
Ken Sutton,388,23,80,103,0.265,338,D,1990,2002
David Shand,421,19,84,103,0.245,544,D,1976,1985
Henry Boucha,247,53,49,102,0.413,157,C,1971,1977
Colin Greening,286,45,57,102,0.35700000000000004,150,C/LW,2010,2016
Marc Fortier,212,42,60,102,0.48100000000000004,135,C,1987,1993
Shawn Thornton,705,42,60,102,0.145,1103,RW,2002,2017
Larry Keenan,233,38,64,102,0.43799999999999994,28,LW,1961,1972
Alexander Khavanov,348,27,75,102,0.293,233,D,2000,2006
Juha Ylonen,341,26,76,102,0.299,100,C,1996,2002
Hal Laycoe,531,25,77,102,0.192,292,D,1945,1956
Brett Pesce,353,20,82,102,0.289,105,D,2015,2021
Ben Lovejoy,544,20,82,102,0.188,287,D,2008,2019
Calvin de Haan,412,15,87,102,0.248,150,D,2011,2021
Markus Granlund,335,58,43,101,0.301,86,C/LW,2013,2020
Paul Broten,322,46,55,101,0.314,264,RW,1989,1996
Devante Smith-Pelly,395,44,57,101,0.256,137,RW,2011,2019
Andy Delmore,283,43,58,101,0.35700000000000004,105,D,1998,2006
Tom Pyatt,445,43,58,101,0.22699999999999998,71,C,2009,2019
Larry Jeffrey,368,39,62,101,0.27399999999999997,293,LW,1961,1969
Rob McClanahan,224,38,63,101,0.451,126,LW,1979,1984
Alexander Burmistrov,348,37,64,101,0.29,139,C,2010,2018
Valeri Nichushkin,293,36,65,101,0.345,36,RW/LW,2013,2021
Jim Wiemer,325,29,72,101,0.311,378,D/LW,1982,1994
Esa Lindell,309,28,73,101,0.327,91,D,2015,2021
Brendan Smith,480,24,77,101,0.21,523,D/LW,2011,2021
Yvon Labre,371,14,87,101,0.272,788,D,1970,1981
Art Gagne,228,67,33,100,0.439,257,RW,1926,1932
Didier Pitre,127,64,36,100,0.787,84,F,1917,1923
Ryan Jones,334,54,46,100,0.299,181,LW/RW,2008,2014
Miles Wood,272,51,49,100,0.368,327,LW,2015,2021
Vic Ripley,278,51,49,100,0.36,173,C,1928,1935
Rosaire Paiement,190,48,52,100,0.526,343,C,1967,1972
Daniel Carcillo,429,48,52,100,0.233,1233,LW,2006,2015
Jim McKenzie,880,48,52,100,0.114,1739,LW,1989,2004
Terry Reardon,193,47,53,100,0.518,73,C,1938,1947
Jesper Bratt,185,37,63,100,0.541,30,LW/RW,2017,2021
Vinnie Hinostroza,247,34,66,100,0.405,61,C/RW,2015,2021
Michael Thelven,207,20,80,100,0.483,217,D,1985,1990
Mike Rupp,609,54,45,99,0.163,855,W/C,2002,2014
Eddie Gerard,128,50,49,99,0.773,108,LW,1917,1923
Louis Sleigher,194,46,53,99,0.51,146,RW,1979,1986
Pentti Lund,259,44,55,99,0.382,40,C,1946,1953
Jamie Lundmark,295,40,59,99,0.336,204,C,2002,2010
Erik Condra,372,40,59,99,0.266,176,RW/LW,2010,2019
Ryan Shannon,305,35,64,99,0.325,90,C/RW,2006,2012
Jim Dorey,232,25,74,99,0.42700000000000005,553,D,1968,1972
Larry Goodenough,242,22,77,99,0.409,179,D,1974,1980
Steve Eminger,488,19,80,99,0.203,359,D,2002,2013
Jack Evans,753,19,80,99,0.131,989,D,1948,1963
Bob Armstrong,542,13,86,99,0.183,671,D,1950,1962
Blake Coleman,249,59,39,98,0.39399999999999996,206,C/W,2016,2021
Scott Pearson,292,56,42,98,0.336,615,LW,1988,2000
Anders Hakansson,330,52,46,98,0.297,141,LW,1981,1986
David Oliver,233,49,49,98,0.42100000000000004,82,RW,1994,2006
Bruce Crowder,243,47,51,98,0.40299999999999997,156,RW,1981,1985
Anthony Cirelli,171,41,57,98,0.573,70,C,2017,2021
Nick Cousins,328,41,57,98,0.299,142,C/W,2014,2021
Bob Neely,283,39,59,98,0.34600000000000003,266,D,1973,1978
Sebastien Bordeleau,251,37,61,98,0.39,98,C,1995,2002
Connor Murphy,449,26,72,98,0.218,246,D,2013,2021
Thomas Eriksson,208,22,76,98,0.47100000000000003,97,D,1980,1986
Leo Lamoureux,235,19,79,98,0.41700000000000004,175,C,1941,1947
Dave Karpa,557,18,80,98,0.17600000000000002,1374,D,1991,2003
Ryan Reaves,654,48,49,97,0.14800000000000002,910,RW,2010,2021
Dave Brown,729,45,52,97,0.133,1789,RW,1982,1996
Ondrej Kase,206,43,54,97,0.47100000000000003,48,RW,2016,2021
Gary Aldcorn,226,41,56,97,0.429,78,LW,1956,1961
Bill Muckalt,256,40,57,97,0.379,204,RW,1998,2003
Johan Larsson,398,38,59,97,0.244,194,C/LW,2012,2021
Clarke Wilm,455,37,60,97,0.213,336,C,1998,2006
Todd Fedoruk,545,32,65,97,0.17800000000000002,1050,LW,2000,2010
Greg Joly,365,21,76,97,0.266,250,D,1974,1983
Josh Manson,388,21,76,97,0.25,350,D,2014,2021
Randy Velischek,509,21,76,97,0.191,401,D,1982,1992
John Barrett,488,20,77,97,0.19899999999999998,604,D,1980,1988
Mike Weaver,633,8,89,97,0.153,227,D,2001,2015
George Prodger,111,63,33,96,0.865,39,C,1919,1925
Jake Virtanen,285,51,45,96,0.337,182,RW,2015,2021
Gerry Lowrey,211,48,48,96,0.455,148,C,1927,1933
Tom Roulston,195,47,49,96,0.49200000000000005,74,RW,1980,1986
Danny Cox,319,47,49,96,0.301,128,LW,1926,1934
Fern Gauthier,229,46,50,96,0.419,35,RW,1943,1949
Don Ashby,188,40,56,96,0.511,40,C,1975,1981
Jerred Smithson,606,39,57,96,0.158,363,C/RW,2002,2014
Joe Cooper,420,30,66,96,0.22899999999999998,442,D,1935,1947
Red Dutton,449,29,67,96,0.214,871,D,1926,1936
Cam Barker,310,21,75,96,0.31,290,D,2005,2013
Bill Dineen,323,51,44,95,0.294,122,RW,1953,1958
Juraj Kolnik,250,46,49,95,0.38,84,RW,2000,2007
Chris Valentine,105,43,52,95,0.905,127,F,1981,1984
Gilbert Brule,299,43,52,95,0.318,156,C/RW,2005,2014
Al Hill,221,40,55,95,0.43,227,C,1976,1988
Mark Pederson,169,35,50,95,0.562,77,RW,1989,1994
Bryan Maxwell,331,18,77,95,0.287,745,D,1977,1985
Cale Hulse,619,16,79,95,0.153,1000,D,1995,2006
Andre Dore,257,14,81,95,0.37,261,D,1978,1985
Will Butcher,215,13,82,95,0.442,32,D,2017,2021
Yannick Weber,497,28,66,94,0.18899999999999997,195,D,2008,2020
David Schlemko,415,18,76,94,0.22699999999999998,124,D,2008,2019
Rick Paterson,430,50,43,93,0.21600000000000003,136,C,1978,1987
Colton Sissons,326,47,46,93,0.285,113,C/W,2013,2021
Brock McGinn,311,43,50,93,0.299,75,LW/RW,2015,2021
Patrick Dwyer,416,42,51,93,0.22399999999999998,77,RW,2008,2015
Ted Drury,414,41,52,93,0.225,367,C,1993,2001
Ryan Carter,473,41,52,93,0.19699999999999998,444,C,2006,2016
Wally Kilrea,329,35,58,93,0.28300000000000003,87,LW,1929,1938
Norm Dussault,206,31,62,93,0.451,47,C,1947,1951
Denny Lambert,487,27,66,93,0.191,1391,LW,1994,2002
Mark Stuart,673,26,67,93,0.138,722,D,2005,2017
Albert Leduc,383,57,35,92,0.24,614,D,1925,1935
Reggie Sinclair,208,49,43,92,0.442,139,F,1950,1953
Brady Tkachuk,146,44,48,92,0.63,190,LW,2018,2021
J.T. Compher,228,43,49,92,0.40399999999999997,77,C/W,2016,2021
Kasperi Kapanen,204,41,51,92,0.451,55,RW/LW,2015,2021
Ronald Petrovicky,342,41,51,92,0.26899999999999996,429,RW,2000,2007
Larry Mickey,292,39,53,92,0.315,160,RW,1964,1975
Al Karlander,212,36,56,92,0.434,70,C,1969,1973
Ken Yaremchuk,235,36,56,92,0.391,106,C,1983,1989
Rick Chartraw,420,28,64,92,0.21899999999999997,399,D,1974,1984
Brandon Montour,248,24,68,92,0.371,142,D,2016,2021
Charlie McAvoy,188,19,73,92,0.489,147,D,2016,2021
Peter Taglianetti,451,18,74,92,0.204,1106,D,1984,1995
Al MacNeil,524,17,75,92,0.17600000000000002,617,D,1955,1968
Neil Komadoski,502,16,76,92,0.183,602,D,1972,1980
Shane O'Brien,537,13,79,92,0.171,916,D,2006,2015
Nick Wasnie,248,57,34,91,0.36700000000000005,176,RW,1927,1935
Dmitri Kvartalnov,112,42,49,91,0.813,26,LW,1992,1994
Aaron Gavey,360,41,50,91,0.253,272,C,1995,2006
Alex Smith,443,41,50,91,0.205,645,D,1924,1935
Rob Ray,900,41,50,91,0.10099999999999999,3207,RW,1989,2004
Paul Meger,212,39,52,91,0.429,118,LW,1949,1955
Pascal Rheaume,318,39,52,91,0.28600000000000003,144,C/LW,1996,2006
Lew Morrison,564,39,52,91,0.161,107,RW,1969,1978
Mike Matheson,301,33,58,91,0.302,161,D,2015,2021
James Sheppard,394,23,68,91,0.231,192,C/LW,2007,2015
John Slaney,268,22,69,91,0.34,99,D,1993,2004
Geoff Smith,462,18,73,91,0.19699999999999998,282,D,1989,1999
Nick Kypreos,442,46,44,90,0.204,1210,LW,1989,1997
"Harvey Bennett, Jr.",268,44,46,90,0.336,347,C,1974,1979
Frank Carson,248,42,48,90,0.363,166,RW,1925,1934
Brian Sutherby,460,41,49,90,0.196,533,C,2001,2011
John Carter,244,40,50,90,0.369,201,LW,1985,1993
Warren Miller,262,40,50,90,0.344,137,RW/C,1979,1983
Mike Peluso,458,38,52,90,0.19699999999999998,1951,D/LW,1989,1998
Dan Hinote,503,38,52,90,0.179,383,RW,1999,2009
Luciano Borsato,203,35,55,90,0.44299999999999995,113,C,1990,1995
Rik Wilson,251,25,65,90,0.359,220,D,1981,1988
Chris Dahlquist,532,19,71,90,0.16899999999999998,488,D,1985,1996
Daniel Tjarnqvist,352,18,72,90,0.256,128,D,2001,2009
Brayden McNabb,471,18,72,90,0.191,367,D,2011,2021
Larry Carriere,367,16,74,90,0.245,462,D,1972,1980
Dale Hoganson,343,13,77,90,0.262,186,D,1969,1982
Nathan Beaulieu,374,12,78,90,0.24100000000000002,263,D,2012,2021
Matt Ravlich,410,12,78,90,0.22,364,D,1962,1973
Hap Emms,320,36,53,89,0.278,311,LW,1926,1938
Iain Duncan,127,34,55,89,0.701,149,LW,1986,1991
Paulin Bordeleau,183,33,56,89,0.486,47,C,1973,1976
Art Somers,222,33,56,89,0.401,189,C,1929,1935
Dave Kryskow,231,33,56,89,0.385,174,LW,1972,1976
Herb Raglan,343,33,56,89,0.259,775,LW,1985,1994
Glen Cochrane,411,17,72,89,0.217,1556,D,1978,1989
Greg Hotham,230,15,74,89,0.387,139,D,1979,1985
Larry Giroux,274,15,74,89,0.325,333,D,1973,1980
Samuel Girard,230,12,77,89,0.387,33,D,2017,2021
Yvon Corriveau,280,48,40,88,0.314,310,LW,1985,1994
Allan Shields,459,42,46,88,0.192,637,D,1927,1938
Jeff Larmer,158,37,51,88,0.557,57,LW,1981,1986
Bruce Gardiner,312,34,54,88,0.282,263,C,1996,2002
Pete Laframboise,227,33,55,88,0.38799999999999996,70,LW,1971,1975
Mark Pysyk,418,22,66,88,0.21100000000000002,126,D/RW,2012,2021
Nathan Dempsey,260,21,67,88,0.33799999999999997,120,D,1996,2007
Neal Pionk,176,13,75,88,0.5,79,D,2017,2021
Al Hamilton,257,10,78,88,0.342,258,D,1965,1980
Cully Wilson,130,59,28,87,0.669,245,RW,1919,1927
David Bruce,234,48,39,87,0.37200000000000005,338,LW,1985,1994
Roman Oksiuta,153,46,41,87,0.569,96,RW,1993,1997
"Ken Hodge, Jr.",142,39,48,87,0.613,32,C,1988,1993
Mike Laughton,189,39,48,87,0.46,101,C,1967,1971
Ryan Garbutt,305,39,48,87,0.285,283,W/C,2011,2017
Pierre-Edouard Bellemare,459,38,49,87,0.19,106,C/LW,2014,2021
Jason Lafreniere,146,34,53,87,0.596,22,C,1986,1994
Bob Carse,167,32,55,87,0.521,52,LW,1939,1948
Joe Jerwa,204,29,58,87,0.426,309,D,1930,1939
Randy Boyd,257,20,67,87,0.33899999999999997,328,D,1981,1989
Tom Edur,158,17,70,87,0.551,67,D,1976,1978
Bruno Gervais,418,16,71,87,0.20800000000000002,182,D,2005,2013
Andreas Lilja,580,16,71,87,0.15,563,D,2000,2013
Pete Conacher,229,47,39,86,0.376,57,LW,1951,1958
Steve Guolla,205,40,46,86,0.42,60,C,1996,2003
Jeff Jackson,263,38,48,86,0.327,313,LW,1984,1992
Ivan Johnson,436,38,48,86,0.19699999999999998,808,D,1926,1938
Bob Dillabough,283,32,54,86,0.304,76,C,1961,1970
Wes Jarvis,237,31,55,86,0.363,98,C,1979,1988
Murray Henderson,405,24,62,86,0.212,305,D,1944,1952
Jean Lemieux,204,23,63,86,0.42200000000000004,39,D,1973,1978
Ben Chiarot,379,22,64,86,0.22699999999999998,264,D,2013,2021
Pete Goegan,383,19,67,86,0.225,365,D,1957,1968
Ben Hutton,341,15,71,86,0.252,125,D,2015,2021
Chris Butler,407,14,72,86,0.21100000000000002,187,D,2008,2019
Nicklas Grossmann,592,13,73,86,0.145,314,D,2006,2017
Red Green,195,59,26,85,0.436,290,LW,1923,1929
Cedric Paquette,381,47,38,85,0.223,349,C,2013,2021
Tom Younghans,429,44,41,85,0.198,373,RW,1976,1982
Ben Eager,407,43,42,85,0.209,875,LW,2005,2014
Peter Holland,266,36,49,85,0.32,112,C,2011,2018
Bob Wall,322,30,55,85,0.264,158,D,1964,1972
Jakob Chychrun,239,29,56,85,0.35600000000000004,133,D,2016,2021
Mark Eaton,650,24,61,85,0.131,242,D,1999,2013
Chris Tamer,644,21,64,85,0.132,1183,D,1993,2004
Denis Grebeshkov,234,17,68,85,0.363,114,D,2003,2014
Barry Ashbee,284,15,70,85,0.299,288,D,1965,1974
Aki-Petteri Berg,606,15,70,85,0.14,374,D,1995,2006
Paul Shmyr,343,13,72,85,0.248,528,D,1968,1982
Miroslav Dvorak,193,11,74,85,0.44,51,D,1982,1985
Jack Skille,368,43,41,84,0.228,118,RW/LW,2007,2017
Denis Cyr,193,41,43,84,0.435,36,RW,1980,1986
Jay Miller,446,40,44,84,0.188,1723,LW,1985,1992
Nigel Dawes,212,39,45,84,0.396,43,LW,2006,2011
Mark Kumpel,288,38,46,84,0.292,113,RW,1984,1991
Barry Cullen,219,32,52,84,0.384,111,RW,1955,1960
Dave Snuggerud,265,30,54,84,0.317,127,RW,1989,1993
Billy Carroll,322,30,54,84,0.261,113,C,1980,1987
Craig Redmond,191,16,68,84,0.44,134,D,1984,1989
Rasmus Dahlin,146,13,71,84,0.575,74,D,2018,2021
Rick Ley,310,12,72,84,0.271,392,D,1968,1981
Merlyn Phillips,302,52,31,83,0.275,232,C,1925,1933
Jeff Cowan,434,47,36,83,0.191,727,LW,1999,2008
Norm Gratton,201,39,44,83,0.413,64,RW,1971,1976
Murray Hall,164,35,48,83,0.506,46,RW,1961,1972
Niclas Bergfors,173,35,48,83,0.48,20,RW,2007,2012
Bob Joyce,158,34,49,83,0.525,90,LW,1987,1993
Sven Andrighetto,216,31,52,83,0.384,42,W/C,2014,2019
Harold Phillipoff,141,26,57,83,0.589,267,LW,1977,1980
Vince Dunn,228,26,57,83,0.364,94,D,2017,2021
Neil Wilkinson,460,16,67,83,0.18,813,D,1989,1999
Mike McMahon Jr.,224,15,68,83,0.371,171,D,1963,1972
Robert Nordmark,236,13,70,83,0.35200000000000004,254,D,1987,1991
Jeff Finley,708,13,70,83,0.11699999999999999,457,D,1987,2004
Brian Dumoulin,352,11,72,83,0.23600000000000002,96,D,2013,2021
Dick Gamble,195,41,41,82,0.42100000000000004,66,LW,1950,1967
Milan Kraft,207,41,41,82,0.396,52,C,2000,2004
Eddie Bruneteau,180,40,42,82,0.456,35,RW,1940,1949
Joffre Desilets,192,37,45,82,0.42700000000000005,57,C,1935,1940
Jaroslav Pouzar,186,34,48,82,0.441,135,LW,1982,1987
Niklas Andersson,165,29,53,82,0.49700000000000005,85,LW,1992,2001
Peter Sullivan,126,28,54,82,0.6509999999999999,40,F,1979,1981
Matt Irwin,359,22,60,82,0.228,150,D,2012,2021
Rod Buskas,556,19,63,82,0.147,1294,D,1982,1993
Doug Houda,561,19,63,82,0.146,1104,D,1985,2003
Ville Siren,290,14,68,82,0.28300000000000003,276,D,1985,1990
Bert Wilson,478,37,44,81,0.16899999999999998,646,LW,1973,1981
Jason Ward,336,36,45,81,0.24100000000000002,171,RW,1999,2009
Toby Petersen,398,33,48,81,0.204,50,C,2000,2013
Paul Mulvey,225,30,51,81,0.36,613,LW,1978,1982
Barry Dean,165,25,56,81,0.491,146,LW,1976,1979
Milan Jurcina,430,22,59,81,0.188,280,D,2005,2012
Vyacheslav Voynov,190,18,63,81,0.426,72,D,2011,2015
Alexei Yemelin,456,15,66,81,0.17800000000000002,363,D,2011,2018
Sheldon Kannegiesser,366,14,67,81,0.221,292,D,1970,1978
Mike Komisarek,551,14,67,81,0.147,679,D,2002,2014
Mark Lofthouse,181,42,38,80,0.442,73,RW,1977,1983
Doug Young,388,35,45,80,0.20600000000000002,303,D,1931,1941
B.J. Crombeen,445,34,46,80,0.18,850,RW,2007,2015
Paul Andrea,150,31,49,80,0.5329999999999999,10,RW,1965,1971
Paul DiPietro,192,31,49,80,0.41700000000000004,96,C,1991,1997
Hy Buller,188,22,58,80,0.426,215,D,1943,1954
Brad Werenka,320,19,61,80,0.25,299,D,1992,2001
Glen Featherstone,384,19,61,80,0.20800000000000002,939,D,1988,1997
Matt Greene,615,17,63,80,0.13,663,D,2005,2017
Bruce Affleck,280,14,66,80,0.28600000000000003,86,D,1974,1984
Nikita Zaitsev,285,13,67,80,0.281,111,D,2016,2021
Terry Murray,302,4,76,80,0.265,199,D,1972,1982
Drake Caggiula,227,41,38,79,0.348,117,C/W,2016,2021
Sandy Moger,236,41,38,79,0.335,212,RW,1994,1999
Yevgeni Davydov,155,40,39,79,0.51,120,RW,1991,1995
Oscar Lindberg,252,39,40,79,0.313,117,C/LW,2014,2019
Ivan Barbashyov,236,37,42,79,0.335,46,C/LW,2016,2021
Brandon Tanev,268,37,42,79,0.295,103,LW/RW,2015,2021
David Steckel,425,33,46,79,0.18600000000000003,129,C,2005,2014
Eric Boulton,654,31,48,79,0.121,1421,LW,2000,2016
Alex Hicks,258,25,54,79,0.306,247,LW,1995,2000
Christian Backman,301,23,56,79,0.262,182,D,2002,2009
Niclas Wallin,614,21,58,79,0.129,460,D,2000,2011
Pat Ribble,349,19,60,79,0.226,365,D,1975,1983
Barry Long,280,11,68,79,0.282,250,D,1972,1982
Bill Carson,159,54,24,78,0.491,156,C,1926,1930
George Patterson,284,51,27,78,0.275,218,RW,1926,1935
Leo Gravelle,223,44,34,78,0.35,42,RW,1946,1951
Bert McCaffrey,260,43,35,78,0.3,200,D/W,1924,1931
Mike Hartman,397,43,35,78,0.196,1388,LW,1986,1995
Blair Betts,477,41,37,78,0.16399999999999998,118,C,2001,2012
Austin Watson,310,37,41,78,0.252,364,W/C,2012,2021
Marc Chouinard,320,37,41,78,0.244,123,C,2000,2007
Blair Stewart,229,34,44,78,0.341,326,F,1973,1980
Gus Giesebrecht,135,27,51,78,0.578,13,C,1938,1942
Bill Brydge,368,26,52,78,0.212,506,D,1926,1936
John McIntyre,351,24,54,78,0.222,516,C,1989,1995
Greg Theberge,153,15,63,78,0.51,73,D,1979,1984
George Owen,183,44,33,77,0.42100000000000004,151,D,1928,1933
Randy Rota,212,38,39,77,0.363,60,LW,1972,1977
Warren Rychel,406,38,39,77,0.19,1422,LW,1988,1999
Daniel Frawley,273,37,40,77,0.282,674,RW,1983,1989
Jeff Hamilton,157,32,45,77,0.49,44,C/RW,2003,2009
Mike Bloom,201,30,47,77,0.38299999999999995,215,LW,1974,1977
Stewart Evans,367,28,49,77,0.21,425,D,1930,1939
Hank Ciesla,269,26,51,77,0.28600000000000003,87,C,1955,1959
Robert Thomas,140,19,58,77,0.55,34,C/RW,2018,2021
Ric Jackman,231,19,58,77,0.33299999999999996,166,D,1999,2007
Denis Gauthier,554,17,60,77,0.139,748,D,1997,2009
Pavel Trnka,411,14,63,77,0.187,323,D,1997,2004
Todd Simpson,580,14,63,77,0.133,1357,D,1995,2006
Rich Pilon,631,8,69,77,0.122,1745,D,1988,2002
Brendan Perlini,239,46,30,76,0.318,86,LW/C,2016,2020
Mike Byers,166,42,34,76,0.45799999999999996,39,RW,1967,1972
Raimo Summanen,151,36,40,76,0.503,35,LW,1983,1988
Josh Green,341,36,40,76,0.223,206,C/LW,1998,2012
Todd Ewen,518,36,40,76,0.147,1914,RW,1986,1997
Eric Boguniecki,178,34,42,76,0.42700000000000005,105,RW,1999,2007
Dan Fritsche,256,34,42,76,0.297,103,C/W,2003,2009
Mike Gillis,246,33,43,76,0.309,186,LW,1978,1984
Mikko Eloranta,264,32,44,76,0.28800000000000003,186,LW,1999,2003
Alan May,393,31,45,76,0.193,1348,LW,1987,1995
Lance Bouma,357,30,46,76,0.213,210,LW/C,2010,2018
Stacy Roest,244,28,48,76,0.311,54,C,1998,2003
Kevin Connauton,314,27,49,76,0.242,177,D,2013,2021
Nikita Zadorov,361,22,54,76,0.21100000000000002,385,D,2013,2021
Brett Lebda,397,20,56,76,0.191,229,D,2005,2012
Jake McCabe,345,18,58,76,0.22,199,D,2013,2021
Nikita Nikitin,259,17,59,76,0.293,85,D,2010,2016
Bruce Bell,209,12,64,76,0.364,113,D,1984,1990
Jeff Schultz,409,11,65,76,0.18600000000000003,137,D,2006,2016
Tyler Pitlick,253,42,33,75,0.29600000000000004,66,C/W,2013,2021
Tom Webster,102,33,42,75,0.735,61,RW,1968,1980
Matt Halischuk,280,33,42,75,0.268,57,RW,2008,2016
Tim Jackman,483,32,43,75,0.155,806,RW,2003,2016
Ivan Novoseltsev,234,31,44,75,0.321,112,LW,1999,2004
Harry York,244,29,46,75,0.307,99,C,1996,2000
Cory Conacher,193,28,47,75,0.389,118,C/W,2012,2020
Barclay Goodrow,279,26,49,75,0.26899999999999996,256,C/W,2014,2021
Eric Messier,406,25,50,75,0.185,146,D/LW,1996,2004
Jay Harrison,372,23,52,75,0.20199999999999999,360,D,2005,2015
Craig Levie,183,22,53,75,0.41,177,D,1981,1987
Joel Bouchard,364,22,53,75,0.20600000000000002,264,D,1994,2006
Craig Norwich,104,17,58,75,0.721,60,D,1979,1981
Noel Picard,335,12,63,75,0.22399999999999998,616,D,1964,1973
Troy Stecher,291,11,64,75,0.258,124,D,2016,2021
Shaone Morrisonn,480,11,64,75,0.156,455,D,2002,2011
Louis Berlinquette,193,42,32,74,0.38299999999999995,123,LW,1917,1926
Gene Ubriaco,177,39,35,74,0.418,50,LW/C,1967,1970
Shane Willis,174,31,43,74,0.425,77,RW,1998,2004
Dan Hodgson,114,29,45,74,0.649,64,C,1985,1989
John McCormack,311,25,49,74,0.23800000000000002,35,C,1947,1955
Dean Hopkins,223,23,51,74,0.332,306,RW,1979,1989
Bryan Fogarty,156,22,52,74,0.474,119,D,1989,1995
Patrick Wiercioch,268,16,58,74,0.276,138,D,2010,2017
Jakub Kindl,331,16,58,74,0.22399999999999998,181,D,2009,2017
Howie Young,336,12,62,74,0.22,851,D,1960,1971
Mike Kitchen,474,12,62,74,0.156,370,D,1976,1984
Larry Melnyk,432,11,63,74,0.171,686,D,1980,1990
Frank Fredrickson,161,39,34,73,0.45299999999999996,206,C,1926,1931
Jimmy Peters Jr.,309,37,36,73,0.23600000000000002,48,C,1964,1975
Andy Spruce,172,31,42,73,0.424,111,LW,1976,1979
Marty Murray,261,31,42,73,0.28,41,C,1995,2007
Evan Rodrigues,204,28,45,73,0.358,57,C/W,2015,2021
Hector Marini,154,27,46,73,0.474,246,RW,1978,1984
Polly Drouin,160,23,50,73,0.456,80,LW,1934,1941
Pete Langelle,136,22,51,73,0.537,11,C,1938,1942
Freddy Meyer,281,20,53,73,0.26,155,D,2003,2011
Joel Edmundson,342,20,53,73,0.213,322,D,2015,2021
Erik Gudbranson,522,20,53,73,0.14,585,D,2011,2021
Ulrich Hiemer,143,19,54,73,0.51,176,D,1984,1987
Adam McQuaid,512,16,57,73,0.14300000000000002,694,D,2009,2019
Steve Durbano,220,13,60,73,0.332,1127,D,1972,1979
Peter Popovic,488,10,63,73,0.15,291,D,1993,2001
Larry Johnston,320,9,64,73,0.228,580,D,1967,1977
Tyson Jost,213,32,40,72,0.33799999999999997,68,C/LW,2016,2021
Mathieu Darche,250,30,42,72,0.28800000000000003,58,LW,2000,2012
Alain Lemieux,119,28,44,72,0.605,38,C,1981,1987
Christoph Schubert,315,25,47,72,0.22899999999999998,263,D,2005,2010
J.T. Brown,365,23,49,72,0.19699999999999998,221,RW,2011,2019
Travis Sanheim,205,20,52,72,0.35100000000000003,74,D,2017,2021
Jayson More,406,18,54,72,0.177,702,D,1988,1999
Bob McGill,705,17,55,72,0.102,1766,D,1981,1994
Adrien Plavsic,214,16,56,72,0.336,161,D,1989,1997
Bob Boughner,630,15,57,72,0.114,1382,D,1995,2006
Paul Laus,530,14,58,72,0.136,1702,D,1993,2002
Ladislav Smid,583,12,60,72,0.12300000000000001,472,D,2006,2017
Lukas Krajicek,328,11,61,72,0.22,245,D,2001,2010
Paul Kruse,423,38,33,71,0.168,974,LW,1990,2001
Derek Grant,269,31,40,71,0.264,87,C/LW,2012,2021
Bill Carse,124,28,43,71,0.573,38,LW,1938,1942
Phil Maloney,158,28,43,71,0.449,16,C,1949,1960
Lyndon Byers,279,28,43,71,0.254,1081,LW,1983,1993
Joel Eriksson Ek,215,27,44,71,0.33,68,C/W,2016,2021
Anthony Stewart,262,27,44,71,0.271,123,RW,2005,2012
Andrew Ebbett,224,26,45,71,0.317,50,C/LW,2007,2015
Shane Churla,488,26,45,71,0.145,2301,RW,1986,1997
Ian Moran,489,21,50,71,0.145,321,D,1994,2007
Roger Leger,187,18,53,71,0.38,71,D,1943,1950
Lubomir Sekeras,213,18,53,71,0.33299999999999996,122,D,2000,2004
Shane Hnidy,550,16,55,71,0.129,633,D,2000,2011
Grant Clitsome,205,15,56,71,0.34600000000000003,98,D,2009,2016
Jack Portland,381,15,56,71,0.18600000000000003,323,D,1933,1943
Jack Hillen,304,13,58,71,0.23399999999999999,157,D,2007,2015
Radoslav Suchy,451,13,58,71,0.157,104,D,1999,2006
Joe Micheletti,158,11,60,71,0.449,114,D/C,1979,1982
Bill Stewart,260,7,64,71,0.273,424,D,1977,1986
John Quilty,125,36,34,70,0.56,81,C,1940,1948
Kilby MacDonald,151,36,34,70,0.46399999999999997,47,LW,1939,1945
Brad Palmer,168,32,38,70,0.41700000000000004,58,LW,1980,1983
Bruce Boudreau,141,28,42,70,0.496,44,C,1976,1986
Michel Picard,166,28,42,70,0.42200000000000004,103,LW,1990,2001
Steve Dubinsky,375,25,45,70,0.187,164,C,1993,2003
Mark Smith,377,23,47,70,0.18600000000000003,457,C,2000,2008
Jesse Winchester,285,20,50,70,0.24600000000000002,159,C/W,2007,2016
Bob Turner,478,19,51,70,0.146,307,D,1955,1963
Charlie Bourgeois,290,16,54,70,0.24100000000000002,788,D,1981,1988
Mattias Timander,419,13,57,70,0.16699999999999998,165,D,1996,2004
Al Arbour,626,12,58,70,0.11199999999999999,617,D,1953,1971
Rob Zettler,569,5,65,70,0.12300000000000001,920,D,1988,2002
Amos Arbour,114,52,17,69,0.605,75,LW,1918,1924
Pat Lundy,150,37,32,69,0.46,31,C,1945,1951
Jordan Weal,218,32,37,69,0.317,56,C/W,2015,2020
Robin Burns,190,31,38,69,0.363,139,LW,1970,1976
Pat Hannigan,182,30,39,69,0.379,116,LW,1959,1969
Tim Trimper,190,30,39,69,0.363,153,LW,1979,1985
Pat Peake,134,28,41,69,0.515,105,RW,1993,1998
Gordon Donnelly,554,28,41,69,0.125,2069,D/RW,1983,1995
Dmitrij Jaskin,303,27,42,69,0.228,88,RW/LW,2012,2019
Dominik Kahun,144,25,44,69,0.479,14,C/W,2018,2021
Tanner Glass,527,24,45,69,0.131,658,LW,2007,2018
Don Nachbaur,223,23,46,69,0.309,465,C,1980,1990
Larry Wilson,152,21,48,69,0.45399999999999996,75,C,1949,1956
Mikhail Tatarinov,161,21,48,69,0.429,184,D,1990,1994
Al Hangsleben,185,21,48,69,0.373,396,D,1979,1982
Miro Heiskanen,151,20,49,69,0.457,28,D,2018,2021
Tom Pederson,240,20,49,69,0.28800000000000003,142,D,1992,1997
Alexandre Picard,253,19,50,69,0.273,86,D,2005,2012
Tapio Levo,107,16,53,69,0.645,36,D,1981,1983
Michal Sykora,267,15,54,69,0.258,185,D,1993,2001
Trevor van Riemsdyk,364,15,54,69,0.19,102,D,2014,2021
Brad Winchester,390,37,31,68,0.174,552,LW,2005,2012
Andre Roy,515,35,33,68,0.132,1169,LW,1995,2009
Garry Peters,311,34,34,68,0.21899999999999997,261,C,1964,1972
Gerry Heffernan,83,33,35,68,0.8190000000000001,27,RW,1941,1944
Joakim Nordstrom,401,31,37,68,0.17,71,C/LW,2013,2021
Bo Berglund,130,28,40,68,0.523,40,RW,1983,1986
Brandon Bochenski,156,28,40,68,0.436,54,RW/C,2005,2010
Justin Fontaine,197,27,41,68,0.345,58,RW,2013,2016
Alex Levinsky,367,19,49,68,0.185,307,D,1930,1939
Ed Hospodar,450,17,51,68,0.151,1314,D,1979,1988
Don Jackson,315,16,52,68,0.21600000000000003,640,D,1977,1987
Vitali Vishnevski,552,16,52,68,0.12300000000000001,494,D,1999,2008
Bill Juzda,398,14,54,68,0.171,398,D,1940,1952
Kent Huskins,318,13,55,68,0.214,173,D,2006,2013
Ossi Vaananen,479,13,55,68,0.142,482,D,2000,2009
Kevan Miller,328,12,56,68,0.207,268,D,2013,2021
Bob McCord,316,10,58,68,0.215,262,RW,1963,1973
Mark Jankowski,213,37,30,67,0.315,59,C,2016,2021
Andreas Johnsson,129,30,37,67,0.519,46,LW/RW,2017,2021
Rod Lorrain,179,28,39,67,0.374,30,RW,1935,1942
Jack Roslovic,180,26,41,67,0.37200000000000005,18,C/RW,2016,2021
Kris Beech,198,25,42,67,0.33799999999999997,113,C,2000,2008
Brian Gibbons,204,25,42,67,0.32799999999999996,58,W/C,2013,2020
Don Blackburn,185,23,44,67,0.36200000000000004,87,LW,1962,1973
Peter Regin,243,23,44,67,0.276,64,C,2008,2015
Gregg Boddy,273,23,44,67,0.245,263,D,1971,1976
Billy McNeill,257,21,46,67,0.261,142,RW,1956,1964
Jason Marshall,526,16,51,67,0.127,1004,D,1991,2006
Ryan Wilson,230,7,60,67,0.29100000000000004,157,D,2009,2015
Dave Hrechkosy,140,42,24,66,0.47100000000000003,41,LW,1973,1977
Hubie McDonough,195,40,26,66,0.33799999999999997,67,C,1988,1993
Josh Leivo,172,31,35,66,0.384,56,LW/RW,2013,2021
Richard Leduc,130,28,38,66,0.508,69,C,1972,1981
Jared Boll,579,28,38,66,0.114,1298,RW,2007,2018
Frank Eddolls,317,23,43,66,0.20800000000000002,114,D,1944,1952
Wally Weir,320,21,45,66,0.20600000000000002,625,RW,1979,1985
Marty Burke,494,19,47,66,0.134,560,D,1927,1938
Jamie Rivers,454,17,49,66,0.145,385,D,1995,2007
Jim Kyte,598,17,49,66,0.11,1342,D,1982,1996
Bob Hoffmeyer,198,14,52,66,0.33299999999999996,325,D,1977,1985
Marshall Johnston,251,14,52,66,0.263,58,D,1967,1974
Tony White,164,37,28,65,0.396,104,LW,1974,1980
Leo Reise,223,36,29,65,0.29100000000000004,181,D,1920,1930
Nicolas Deslauriers,381,33,32,65,0.171,355,LW/D,2013,2021
Bill Jennings,108,32,33,65,0.602,45,RW,1940,1945
Oskar Sundqvist,205,30,35,65,0.317,76,C,2015,2021
Nolan Patrick,150,27,38,65,0.433,59,C,2017,2021
Robert Petrovicky,208,27,38,65,0.313,118,C,1992,2001
Nic Dowd,256,26,39,65,0.254,107,C/RW,2015,2021
Howie Menard,151,23,42,65,0.43,87,C,1963,1970
Mikhail Grigorenko,222,22,43,65,0.293,30,C/LW,2012,2021
Thommie Bergman,246,21,44,65,0.264,243,D,1972,1980
Cody McCormick,405,21,44,65,0.16,550,C/W,2003,2017
Dale DeGray,153,18,47,65,0.425,195,D,1985,1990
Claire Alexander,155,18,47,65,0.419,36,D,1974,1978
Neil Sheehy,379,18,47,65,0.172,1311,D,1983,1992
Mark Fayne,389,17,48,65,0.16699999999999998,131,D,2010,2017
Patrick Traverse,279,14,51,65,0.233,113,D,1995,2006
Nolan Pratt,592,9,56,65,0.11,537,D,1996,2008
Bobby Simpson,175,35,29,64,0.366,98,LW,1976,1983
Lawson Crouse,235,32,32,64,0.272,157,LW,2016,2021
Tyson Nash,374,27,37,64,0.171,673,LW,1998,2006
Beau Bennett,200,24,40,64,0.32,52,RW/LW,2012,2018
Andrew Desjardins,408,23,41,64,0.157,307,W/C,2010,2017
Curtis Lazar,289,22,42,64,0.221,68,C/RW,2014,2021
Jacob Josefson,315,20,44,64,0.203,84,C,2010,2018
Dominik Simon,175,19,45,64,0.366,46,C/W,2015,2021
Len Barrie,184,19,45,64,0.348,290,C,1989,2001
Blake Wesley,298,18,46,64,0.215,486,D,1979,1986
Len Frig,311,13,51,64,0.20600000000000002,479,D,1972,1980
David Williams,173,11,53,64,0.37,157,D,1991,1995
Doug Zmolek,467,11,53,64,0.13699999999999998,905,D,1992,2000
Dylan DeMelo,269,7,57,64,0.23800000000000002,131,D,2015,2021
Douglas Murray,518,7,57,64,0.124,412,D,2005,2014
Mickey MacKay,147,44,19,63,0.429,79,C,1926,1930
Conor Garland,120,37,26,63,0.525,36,RW/LW,2018,2021
Christian Fischer,218,35,28,63,0.289,57,RW/C,2016,2021
Ryan Craig,198,32,31,63,0.318,148,C/LW,2005,2015
Dustin Boyd,220,32,31,63,0.28600000000000003,41,C,2006,2011
Don Tannahill,111,30,33,63,0.568,25,LW,1972,1974
Harold Druken,146,27,36,63,0.43200000000000005,36,C,1999,2004
Rico Fata,230,27,36,63,0.27399999999999997,104,C,1998,2007
Jeff Tambellini,242,27,36,63,0.26,88,LW/RW,2005,2011
Skip Krake,249,23,40,63,0.253,182,C,1963,1971
Paul Stanton,295,14,49,63,0.214,262,D,1990,1995
Bill Nyrop,207,12,51,63,0.304,101,D,1975,1982
Andrej Sustr,324,10,53,63,0.19399999999999998,147,D,2012,2019
Garry Lariviere,219,6,57,63,0.28800000000000003,167,D,1979,1983
Lawrence Sacharuk,151,29,33,62,0.41100000000000003,42,D,1972,1977
Brad Smith,222,28,34,62,0.27899999999999997,591,RW,1978,1987
Lionel Hitchman,417,28,34,62,0.149,523,D,1922,1934
Bill Barilko,252,26,36,62,0.24600000000000002,456,D,1946,1951
Gilles Thibaudeau,119,25,37,62,0.521,40,C,1986,1991
George Lyle,99,24,38,62,0.626,51,LW,1979,1983
Patrik Carnback,154,24,38,62,0.40299999999999997,122,LW,1992,1996
Niko Dimitrakos,158,24,38,62,0.392,95,RW,2002,2007
Phil Hergesheimer,125,21,41,62,0.496,19,RW,1939,1943
Dan Bylsma,429,19,43,62,0.145,184,RW,1995,2004
Mark Mowers,278,18,44,62,0.223,70,C,1998,2008
Aaron Johnson,291,17,45,62,0.213,227,D,2003,2013
Adam Pelech,251,12,50,62,0.247,80,D,2015,2021
Jon Merrill,360,12,50,62,0.172,197,D,2013,2021
Greg Zanon,493,12,50,62,0.126,230,D,2005,2013
Shawn Anderson,255,11,51,62,0.243,117,D,1986,1995
Quinn Hughes,79,8,54,62,0.785,28,D,2018,2021
Bob Paradise,368,8,54,62,0.168,393,D,1971,1979
Colin Forbes,311,33,28,61,0.196,213,C,1996,2006
Bill Riley,139,31,30,61,0.439,320,F,1974,1980
Fred Ahern,146,31,30,61,0.418,130,RW,1974,1978
Marcel Hossa,237,31,30,61,0.257,106,LW/RW,2001,2008
Ryan White,313,31,30,61,0.195,447,C/RW,2009,2017
Ken Priestlay,168,27,34,61,0.363,63,C,1986,1992
Brian Flynn,275,27,34,61,0.222,32,C/W,2012,2017
Stanislav Chistov,196,19,42,61,0.311,116,LW,2002,2007
Chris Evans,241,19,42,61,0.253,143,D,1969,1975
Iiro Jarvi,116,18,43,61,0.526,58,RW,1988,1990
Matt Benning,252,15,46,61,0.242,130,D,2016,2021
Jim McElmury,180,14,47,61,0.33899999999999997,49,D,1972,1978
Michal Kempny,232,14,47,61,0.263,130,D,2016,2021
Perry Miller,217,10,51,61,0.281,387,D,1977,1981
Hugh Bolton,235,10,51,61,0.26,221,D,1949,1957
Brett Ritchie,268,35,25,60,0.22399999999999998,177,RW,2014,2020
Oskar Lindblom,139,32,28,60,0.43200000000000005,32,LW/RW,2017,2021
Marcus Sorensen,202,31,29,60,0.297,58,LW/RW,2016,2021
Gord Hannigan,161,29,31,60,0.373,117,C,1952,1956
Percy Galbraith,347,29,31,60,0.17300000000000001,224,LW,1926,1934
Jack Hamilton,102,28,32,60,0.588,20,LW,1942,1946
Denis Malgin,192,28,32,60,0.313,42,C/W,2016,2020
Blair Atcheynum,196,27,33,60,0.306,36,RW,1992,2001
Adam Burish,378,27,33,60,0.159,554,RW/LW,2006,2015
Fido Purpur,144,25,35,60,0.41700000000000004,46,RW,1934,1945
Jim Cummins,511,24,36,60,0.11699999999999999,1538,RW,1991,2004
Hec Lalande,151,21,39,60,0.397,120,C,1953,1958
Jackie LeClair,160,20,40,60,0.375,56,C,1954,1957
Kamil Kreps,232,18,42,60,0.259,71,C/RW,2006,2010
Markus Nutivaara,244,17,43,60,0.24600000000000002,30,D,2016,2021
Jamie Pushor,521,14,46,60,0.115,648,D,1995,2006
Jiri Fischer,305,11,49,60,0.19699999999999998,295,D,1999,2006
Larry Brown,455,7,53,60,0.132,180,D,1969,1978
Kevin Maguire,260,29,30,59,0.22699999999999998,782,RW,1986,1992
Zach Sanford,161,28,31,59,0.366,61,LW,2016,2021
Tomas Surovy,126,27,32,59,0.46799999999999997,71,LW/C,2002,2006
Yvon Vautour,204,26,33,59,0.289,401,RW,1979,1985
Everett Sanipass,164,25,34,59,0.36,358,LW,1986,1991
Jack McGill,97,23,36,59,0.608,42,C,1941,1947
Bill Watson,115,23,36,59,0.513,12,RW,1985,1989
Lucas Wallmark,172,23,36,59,0.34299999999999997,60,C,2016,2021
Peter White,220,23,36,59,0.268,36,C,1993,2004
Sean Pronger,260,23,36,59,0.22699999999999998,159,C,1995,2004
Jason Krog,202,22,37,59,0.292,46,C,1999,2009
Pete Kelly,177,21,38,59,0.33299999999999996,68,RW,1934,1942
Len Hachborn,102,20,39,59,0.578,29,C,1983,1986
Sean Kuraly,227,20,39,59,0.26,122,C/LW,2016,2021
Paul Masnick,232,18,41,59,0.254,139,C,1950,1958
Nick Shore,299,18,41,59,0.19699999999999998,98,C,2014,2020
Cliff Pennington,101,17,42,59,0.584,6,C,1960,1963
Brendan Leipsic,187,16,43,59,0.316,53,LW/C,2015,2020
Raimo Helminen,117,13,46,59,0.504,16,C,1985,1989
Noel Acciari,248,38,20,58,0.23399999999999999,101,C/W,2015,2021
Pierre Dagenais,142,35,23,58,0.408,58,LW,2000,2006
Chris Wagner,321,35,23,58,0.18100000000000002,171,C/RW,2014,2021
Josh Archibald,189,33,25,58,0.307,56,RW/LW,2015,2021
Ryan Donato,135,30,28,58,0.43,20,C/LW,2017,2021
Alex Pirus,159,30,28,58,0.365,94,RW,1976,1980
Kevin Porter,249,29,29,58,0.233,60,C/RW,2008,2017
Ron Anderson,251,28,30,58,0.231,146,RW,1967,1972
Damien Brunner,121,25,33,58,0.479,46,RW/LW,2012,2015
Artyom Chubarov,228,25,33,58,0.254,40,C,1999,2004
Byron Ritchie,324,25,33,58,0.179,373,C,1998,2008
Ted Taylor,166,23,35,58,0.349,181,LW,1964,1972
Chandler Stephenson,214,23,35,58,0.271,26,C/LW,2015,2021
Tim Tookey,106,22,36,58,0.547,71,C,1980,1989
Jordan Greenway,159,21,37,58,0.365,91,LW/RW,2017,2021
Colin Fraser,359,20,38,58,0.162,290,C/LW,2006,2015
Brad Hunt,180,18,40,58,0.322,24,D,2013,2021
Jamie Oleksiak,314,18,40,58,0.185,255,D,2012,2021
Robert Bortuzzo,379,16,42,58,0.153,376,D,2011,2021
Ray Timgren,251,14,44,58,0.231,70,LW,1948,1955
Scot Kleinendorst,281,12,46,58,0.20600000000000002,452,D,1982,1990
Bob Gassoff,245,11,47,58,0.237,866,D,1973,1977
Lee Fogolin,427,10,48,58,0.136,575,D,1947,1956
Mike Mottau,321,7,51,58,0.18100000000000002,164,D,2000,2014
Jim Bartlett,191,34,23,57,0.298,273,LW,1954,1961
Tim Schaller,276,29,28,57,0.207,92,C/W,2014,2020
Roope Hintz,119,28,29,57,0.479,40,LW/C,2018,2021
Danny Lawson,219,28,29,57,0.26,61,RW,1967,1972
Garnet Hathaway,246,26,31,57,0.23199999999999998,298,RW/LW,2015,2021
Don Barber,115,25,32,57,0.496,64,RW,1988,1992
Howie Hughes,168,25,32,57,0.33899999999999997,30,RW,1967,1970
Claude Laforge,193,24,33,57,0.295,82,LW,1957,1969
Marc-Antoine Pouliot,192,21,36,57,0.297,76,C/RW,2005,2012
Jeff Finger,198,17,40,57,0.28800000000000003,114,D,2006,2010
Mike Wilson,336,16,41,57,0.17,264,D,1995,2003
Grant Jennings,389,14,43,57,0.147,804,D,1987,1996
Sean Brown,437,14,43,57,0.13,909,D,1996,2006
Jim Pavese,328,13,44,57,0.174,691,D,1981,1989
Dwight Bialowas,164,11,46,57,0.348,46,D,1973,1977
Frank Martin,282,11,46,57,0.20199999999999999,122,D,1952,1958
Trevor Johansen,286,11,46,57,0.19899999999999998,282,D,1977,1982
Nick Jensen,283,6,51,57,0.201,75,D,2016,2021
Timo Blomqvist,243,4,53,57,0.235,293,D,1981,1987
Wilfred Green,103,36,20,56,0.544,220,RW,1923,1928
Brandon Yip,174,29,27,56,0.322,130,RW/LW,2009,2014
Steve Tuttle,144,28,28,56,0.389,12,RW,1988,1991
Brian Conacher,155,28,28,56,0.361,84,LW,1961,1972
Ty Arbour,207,28,28,56,0.271,112,LW,1926,1931
Darroll Powe,329,28,28,56,0.17,214,C/W,2008,2014
Brad Jones,148,25,31,56,0.37799999999999995,122,C,1986,1992
Norm Schmidt,125,23,33,56,0.44799999999999995,73,D,1983,1988
Max Kaminsky,130,22,34,56,0.431,38,C,1933,1937
Rocco Grimaldi,159,21,35,56,0.35200000000000004,28,C/RW,2014,2021
Craig Darby,196,21,35,56,0.28600000000000003,32,C,1994,2004
Mattias Weinhandl,182,19,37,56,0.308,70,RW,2002,2007
Joe Paterson,291,19,37,56,0.192,829,LW,1980,1989
Ralph Nattrass,223,18,38,56,0.251,308,D,1946,1950
Stephen Gionta,301,16,40,56,0.18600000000000003,95,C/RW,2010,2019
Filip Hronek,116,14,42,56,0.483,78,D,2018,2021
Mark Barberio,272,14,42,56,0.20600000000000002,115,D,2012,2020
Ernie Dickens,278,12,44,56,0.201,98,D,1941,1951
Duvie Westcott,201,11,45,56,0.27899999999999997,299,D,2001,2008
Matt Grzelcyk,201,10,46,56,0.27899999999999997,132,D,2016,2021
Mark Renaud,152,6,50,56,0.368,86,D,1979,1984
Derek Forbort,279,6,50,56,0.201,178,D,2015,2021
Hank Nowak,180,26,29,55,0.306,161,LW,1973,1977
Greg Johnston,187,26,29,55,0.294,124,D,1983,1992
Tomi Kallio,140,24,31,55,0.39299999999999996,48,RW,2000,2003
Josh Jooris,213,23,32,55,0.258,87,C/RW,2014,2018
Jeff Toms,236,22,33,55,0.233,59,C,1995,2003
Dick Sarrazin,100,20,35,55,0.55,22,RW,1968,1972
Don Metz,172,20,35,55,0.32,42,RW,1938,1949
Ron Andruff,153,19,36,55,0.359,54,C,1974,1979
Rick Bowness,173,18,37,55,0.318,191,RW,1975,1982
Dave Capuano,104,17,38,55,0.529,56,LW,1989,1994
Steve McCarthy,302,17,38,55,0.182,168,D,1999,2008
Stephane Morin,90,16,39,55,0.611,52,C,1989,1994
Jordan Oesterle,214,15,40,55,0.257,36,D,2014,2021
Dave Dunn,184,14,41,55,0.299,313,D,1973,1976
Eric Gelinas,189,14,41,55,0.29100000000000004,92,D,2012,2017
Jason Strudwick,674,13,42,55,0.08199999999999999,811,D,1995,2011
Cale Makar,62,12,43,55,0.887,14,D,2018,2021
Al Cameron,282,11,44,55,0.195,356,D,1975,1981
Jeff Woywitka,278,9,46,55,0.198,149,D,2005,2012
Andrew Alberts,459,8,47,55,0.12,492,D,2005,2014
Kevin Dean,331,7,48,55,0.166,138,D,1994,2001
Don Spring,259,1,54,55,0.212,80,D,1980,1984
Stefan Noesen,202,31,23,54,0.267,122,RW,2014,2021
Lloyd Klein,164,30,24,54,0.32899999999999996,68,RW,1928,1938
Ben Smith,237,29,25,54,0.228,9,RW/C,2010,2017
Dmitri Afanasenkov,227,27,27,54,0.23800000000000002,52,LW,2000,2007
Patrick Kaleta,348,27,27,54,0.155,542,RW,2006,2015
Terry Gray,147,26,28,54,0.36700000000000005,64,RW,1961,1971
Luke Kunin,135,25,29,54,0.4,95,C/RW,2017,2021
Dan Bonar,169,25,39,54,0.32,208,C,1980,1983
Fran Huck,94,24,30,54,0.574,38,C,1969,1973
Rob Schremp,114,20,34,54,0.474,26,C,2006,2011
Greg Carroll,131,20,34,54,0.41200000000000003,44,F,1978,1980
Carter Rowney,209,20,34,54,0.258,34,C/RW,2016,2021
Tom Kuhnhackl,232,18,36,54,0.233,60,RW,2015,2020
Jody Shelley,627,18,36,54,0.086,1538,LW,2000,2013
Roger Jenkins,325,15,39,54,0.166,253,RW,1930,1939
John Erskine,491,15,39,54,0.11,865,D,2001,2015
Scott Mayfield,233,14,40,54,0.23199999999999998,219,D,2013,2021
Poul Popiel,224,13,41,54,0.24100000000000002,210,D,1965,1980
Ken Baumgartner,696,13,41,54,0.078,2242,LW/D,1987,1999
Ricard Persson,229,10,44,54,0.23600000000000002,262,D,1995,2002
Mike Reilly,207,8,46,54,0.261,76,D,2015,2021
Brad Bombardir,356,8,46,54,0.152,127,D,1997,2004
Billy Coutu,241,33,20,53,0.22,399,D,1917,1927
Mal Davis,100,31,22,53,0.53,34,RW,1978,1986
Dave Cameron,168,25,28,53,0.315,238,C,1981,1984
Mark Arcobello,139,24,29,53,0.381,28,RW/C,2012,2016
Mike Polich,226,24,29,53,0.235,57,C,1976,1981
Gary Rissling,221,23,30,53,0.24,1008,LW,1978,1985
Jed Ortmeyer,345,22,31,53,0.154,161,RW,2003,2012
Claude Vilgrain,89,21,32,53,0.596,78,C,1987,1994
Josef Marha,159,21,32,53,0.33299999999999996,32,C/D,1995,2001
David Roberts,125,20,33,53,0.424,85,LW,1993,1998
Joey Crabb,179,20,33,53,0.29600000000000004,100,RW,2008,2014
Kelly Chase,458,17,36,53,0.11599999999999999,2017,RW,1989,2000
Bryan Muir,279,16,37,53,0.19,281,D,1995,2007
Stanislav Neckar,510,12,41,53,0.10400000000000001,316,D,1994,2004
Bill Moe,261,11,42,53,0.203,163,D,1944,1949
Mike Weber,351,9,44,53,0.151,437,D,2007,2016
Harry Mummery,106,33,19,52,0.491,226,D,1917,1923
Earl Balfour,288,30,22,52,0.18100000000000002,78,LW,1951,1961
Dick Irvin,94,29,23,52,0.5529999999999999,78,C,1926,1929
Filip Chytil,148,28,24,52,0.35100000000000003,22,C,2017,2021
Dave Debol,92,26,26,52,0.565,4,C,1979,1981
Fred Thurier,80,25,27,52,0.65,18,C,1940,1945
Earl Roche,147,25,27,52,0.354,48,RW,1930,1935
Rene Trudell,129,24,28,52,0.40299999999999997,72,F,1945,1948
Jordan Nolan,375,24,28,52,0.139,347,C/LW,2011,2019
Jerry Shannon,180,23,29,52,0.289,80,LW,1933,1938
Daryl Evans,113,22,30,52,0.46,25,LW,1981,1987
Petr Tenkrat,177,22,30,52,0.294,84,RW/LW,2000,2007
Tomas Jurco,213,22,30,52,0.244,64,LW/RW,2013,2021
Ed Gilbert,166,21,31,52,0.313,22,C,1974,1977
Jujhar Khaira,220,21,31,52,0.23600000000000002,153,LW/C,2015,2021
Daniel Geoffrion,111,20,32,52,0.46799999999999997,99,RW,1979,1982
Trevor Powis,130,19,33,52,0.4,25,C,1973,1975
Ryan Carpenter,206,19,33,52,0.252,55,C/RW,2015,2021
John Wright,127,16,36,52,0.409,67,C,1972,1975
Mike Kennedy,145,16,36,52,0.359,112,C,1994,1999
Mark Borowiecki,379,15,37,52,0.13699999999999998,651,D,2011,2021
Brandon Carlo,301,13,39,52,0.17300000000000001,186,D,2016,2021
Doug Barrie,158,10,42,52,0.32899999999999996,268,D,1968,1972
Marcus Pettersson,179,6,46,52,0.29100000000000004,107,D,2017,2021
Adam Pardy,342,4,48,52,0.152,269,D,2008,2017
Ed Harrison,194,27,24,51,0.263,53,C,1947,1951
Doug Rombough,150,24,27,51,0.34,80,C,1972,1976
Jock Callander,109,22,29,51,0.46799999999999997,116,C,1987,1993
Jiri Novotny,189,20,31,51,0.27,66,C,2005,2009
Scott Wilson,193,20,31,51,0.264,58,LW,2014,2020
Art Stratton,95,18,33,51,0.537,24,C,1959,1968
Harold Jackson,219,17,34,51,0.233,208,D,1936,1947
Per Svartvadet,247,17,34,51,0.20600000000000002,58,C,1999,2003
Andreas Karlsson,264,16,35,51,0.193,72,C,1999,2008
Peter Andersson,172,10,41,51,0.297,81,D,1983,1986
Marc Reaume,344,8,43,51,0.14800000000000002,273,D,1954,1971
Brad Chartrand,215,25,25,50,0.233,122,RW,1999,2004
Victor Olofsson,65,24,26,50,0.769,8,LW/RW,2018,2021
Pierre Aubry,202,24,26,50,0.248,133,LW,1980,1985
Lasse Pirjeta,146,23,27,50,0.342,50,C,2002,2006
Chris Conner,180,22,28,50,0.278,38,RW/LW,2006,2015
Marc Crawford,176,19,31,50,0.284,229,LW,1981,1987
Morris Mott,199,18,32,50,0.251,49,RW,1972,1975
Rick Bragnalo,145,15,35,50,0.345,46,C,1975,1979
Ken Leiter,143,14,36,50,0.35,62,D,1984,1990
Devon Toews,121,13,37,50,0.413,20,D,2018,2021
Irv Spencer,230,12,38,50,0.217,127,D,1959,1968
Walt Buswell,368,10,40,50,0.136,164,D,1932,1940
Garnet Exelby,408,7,43,50,0.12300000000000001,584,D,2002,2010
Alexander Petrovic,263,5,45,50,0.19,360,D,2012,2019
Dominik Kubalik,73,32,17,49,0.6709999999999999,18,LW/RW,2019,2021
Duke Keats,82,30,19,49,0.598,113,C,1926,1929
Billy Stuart,195,30,19,49,0.251,151,D,1920,1927
Eddie Burke,106,29,20,49,0.462,55,RW,1931,1935
Tomas Nosek,224,25,24,49,0.21899999999999997,58,C/LW,2015,2021
George McPhee,115,24,25,49,0.426,257,F,1982,1989
Ed Ward,278,23,26,49,0.17600000000000002,354,RW,1993,2001
Ryan Potulny,126,22,27,49,0.389,54,C,2005,2011
Jim Moxey,127,22,27,49,0.386,59,F,1974,1977
Al Johnson,105,21,28,49,0.467,30,RW,1956,1963
Matt Ellis,356,21,28,49,0.138,91,LW,2006,2015
Bobby Butler,130,20,29,49,0.377,28,RW,2009,2014
Yevgeni Artyukhin,199,19,30,49,0.24600000000000002,313,RW/LW,2005,2010
Jason Dickinson,171,18,31,49,0.287,46,C/LW,2015,2021
Chris Tancill,134,17,32,49,0.366,54,C,1990,1998
Jon Morris,103,16,33,49,0.47600000000000003,47,C,1988,1994
Cal O'Reilly,145,16,33,49,0.33799999999999997,14,C,2008,2018
Lance Pitlick,393,16,33,49,0.125,298,D,1994,2002
Phil Di Giuseppe,173,15,34,49,0.28300000000000003,62,LW/RW,2015,2021
Jeff Sharples,105,14,35,49,0.467,70,D,1986,1989
Warren Williams,108,14,35,49,0.45399999999999996,131,RW,1973,1976
Dunc McCallum,187,14,35,49,0.262,230,D,1965,1971
Wayne McBean,211,10,39,49,0.23199999999999998,168,D,1987,1994
Alexander Godynyuk,223,10,39,49,0.22,224,D,1990,1997
Dave Richter,365,9,40,49,0.134,1030,D,1981,1990
Raphael Diaz,201,8,41,49,0.244,62,D,2011,2016
Josef Melichar,349,7,42,49,0.14,300,D,2000,2009
Patrik Nemeth,319,5,44,49,0.154,164,D,2013,2021
Rob Valicevic,193,28,20,48,0.249,61,RW,1998,2004
Warren Foegele,150,25,23,48,0.32,60,W/C,2017,2021
Claude St-Sauveur,79,24,24,48,0.608,23,LW/C,1975,1976
Mike Marson,196,24,24,48,0.245,233,LW,1974,1980
Andrei Loktionov,155,22,26,48,0.31,22,C,2009,2014
Tim Brent,207,21,27,48,0.23199999999999998,76,C,2006,2013
Norm Calladine,63,19,29,48,0.762,8,C,1942,1945
Brad Larsen,294,19,29,48,0.163,134,LW,1997,2008
Milan Novy,73,18,30,48,0.6579999999999999,16,C,1982,1983
Chris VandeVelde,278,18,30,48,0.17300000000000001,95,C/LW,2010,2017
Andrej Nestrasil,128,17,31,48,0.375,18,RW/C,2014,2017
Keith Aucoin,145,17,31,48,0.331,24,C,2005,2014
Brandon Manning,255,14,34,48,0.188,254,D,2011,2020
Jiri Latal,92,12,36,48,0.522,24,D,1989,1992
Andre Benoit,181,11,37,48,0.265,60,D,2010,2016
Todd Reirden,183,11,35,48,0.262,181,D,1998,2004
Matt Gilroy,225,11,37,48,0.213,67,D,2009,2014
Hans Jonsson,242,10,38,48,0.198,92,D,1999,2003
Jean-Guy Lagace,197,9,39,48,0.244,251,D,1968,1976
Tommy Sjodin,106,8,40,48,0.45299999999999996,52,D,1992,1994
Derrick Pouliot,202,8,40,48,0.23800000000000002,81,D,2014,2021
Matt Bartkowski,255,8,40,48,0.188,157,D,2010,2021
Clayton Stoner,360,7,41,48,0.133,459,D,2009,2018
Sonny Milano,127,22,25,47,0.37,36,LW/RW,2015,2021
Des Smith,196,22,25,47,0.24,236,D,1937,1942
Jeff Nielsen,252,20,27,47,0.187,70,RW,1996,2001
Jimmy Fowler,135,18,29,47,0.348,39,D,1936,1939
Ken Hammond,193,18,29,47,0.244,290,D,1984,1993
Jim Jackson,112,17,30,47,0.42,20,LW/D,1982,1988
Connor Carrick,230,12,35,47,0.204,152,D,2013,2021
Jack McIlhargey,393,11,36,47,0.12,1102,D,1974,1982
Nate Prosser,354,10,37,47,0.133,231,D,2009,2021
Nolan Baumgartner,142,7,40,47,0.331,67,D,1995,2010
Brad Selwood,163,7,40,47,0.28800000000000003,153,D,1970,1980
Christian Laflamme,324,2,45,47,0.145,282,D,1996,2004
Howie Glover,144,29,17,46,0.319,101,RW,1958,1969
Dunc Munro,239,28,18,46,0.192,172,D/LW,1924,1932
Andrew Mangiapane,125,25,21,46,0.368,34,W/C,2017,2021
Iain Fraser,94,23,23,46,0.489,31,C,1992,1997
Jean-Pierre Vigier,213,23,23,46,0.21600000000000003,97,RW,2000,2007
Fernand Majeau,56,22,24,46,0.821,43,C,1943,1945
Ron Chipperfield,83,22,24,46,0.5539999999999999,34,C,1979,1981
Emerson Etem,173,22,24,46,0.266,30,RW/LW,2012,2017
Jeff Taffe,180,21,25,46,0.256,40,C,2002,2012
Mark Rycroft,226,21,25,46,0.204,113,RW,2001,2007
Steve Martins,267,21,25,46,0.172,142,C,1995,2006
Colin McDonald,148,20,26,46,0.311,73,RW,2009,2017
Nikolay Goldobin,125,19,27,46,0.368,24,RW/LW,2015,2020
Peter Worrell,391,19,27,46,0.11800000000000001,1554,LW,1997,2004
Don Morrison,112,18,28,46,0.41100000000000003,12,C,1947,1951
Adam Gaudette,126,18,28,46,0.365,59,C,2017,2021
Patrick Rissmiller,192,18,28,46,0.24,60,LW/RW,2003,2011
Alfie Turcotte,112,17,29,46,0.41100000000000003,49,C,1983,1991
Mika Alatalo,152,17,29,46,0.303,58,LW/RW,1999,2001
Mick Vukota,573,17,29,46,0.08,2071,RW,1987,1998
David Kampf,184,16,30,46,0.25,38,C/W,2017,2021
Duke Dukowski,200,16,30,46,0.23,172,D,1926,1934
Ron Huston,79,15,31,46,0.5820000000000001,8,C,1973,1975
Nick Suzuki,76,14,32,46,0.605,12,C,2019,2021
Adam Fox,74,9,37,46,0.622,32,D,2019,2021
Dan Keczmer,235,8,38,46,0.196,212,D,1990,2000
John Miszuk,237,7,39,46,0.19399999999999998,232,D,1963,1970
Leif Svensson,121,6,40,46,0.38,49,D,1978,1980
Dennis Vaske,235,5,41,46,0.196,253,D,1990,1999
Tex White,203,33,12,45,0.222,141,F,1925,1931
Jack Carlson,236,30,15,45,0.191,417,LW,1978,1987
Guy Trottier,115,28,17,45,0.391,37,RW,1968,1972
Dan LaCouture,337,20,25,45,0.134,348,LW,1998,2009
Marko Dano,141,19,26,45,0.319,49,LW/C,2014,2020
Ben Guite,174,19,26,45,0.259,97,C,2005,2010
Jesperi Kotkaniemi,120,18,27,45,0.375,51,C,2018,2021
Krzysztof Oliwa,410,17,28,45,0.11,1447,LW,1996,2006
Brian Perry,96,16,29,45,0.469,24,C,1968,1971
Chris Wideman,181,16,29,45,0.249,104,D,2015,2019
Joel Kwiatkowski,282,16,29,45,0.16,245,D,2000,2008
Wayne Rivers,108,15,30,45,0.41700000000000004,94,RW,1961,1969
Jared Cowen,249,15,31,45,0.18100000000000002,174,D,2009,2016
Craig Coxe,235,14,31,45,0.191,713,LW,1984,1992
Neil Belland,109,13,32,45,0.413,54,D,1981,1987
Don McFadyen,179,12,33,45,0.251,77,C,1932,1936
Barry Richter,151,11,34,45,0.298,76,D,1995,2001
John Mariucci,223,11,34,45,0.20199999999999999,308,D,1940,1948
Petteri Nummelin,139,9,36,45,0.324,34,D,2000,2008
Luc Dufour,167,23,21,44,0.263,199,C,1982,1985
Janne Ojanen,98,21,23,44,0.449,28,C,1988,1993
Gaetano Orlando,98,18,26,44,0.449,51,C,1984,1987
Mark Lawrence,142,18,26,44,0.31,115,RW,1994,2001
Pontus Aberg,132,17,27,44,0.33299999999999996,34,LW/RW,2015,2020
Linden Vey,138,14,30,44,0.319,24,C,2013,2017
Jean-Paul Leblanc,153,14,30,44,0.28800000000000003,87,C,1968,1979
Rudolph Kampman,189,14,30,44,0.233,287,D,1937,1942
Nikita Gusev,70,13,31,44,0.629,12,LW/RW,2019,2021
Michel Briere,76,12,32,44,0.579,20,C,1969,1970
Mathieu Biron,253,12,32,44,0.174,177,D,1999,2006
Joe Vitale,234,11,33,44,0.188,156,C/RW,2010,2017
Jaroslav Bednar,117,10,34,44,0.376,34,LW/RW,2001,2004
Jonathan Girard,150,10,34,44,0.293,46,D,1998,2004
Rasmus Andersson,163,8,36,44,0.27,84,D,2016,2021
Christian Folin,244,8,36,44,0.18,120,D,2013,2020
Sheldon Brookbank,351,7,37,44,0.125,473,D,2006,2014
Norm Barnes,156,6,38,44,0.282,178,D,1976,1982
Howard Riopelle,169,27,16,43,0.254,73,LW,1947,1950
Norm Larson,89,25,18,43,0.483,12,RW,1940,1947
Leo Bourgeault,307,23,20,43,0.14,334,D,1926,1935
Darin Kimble,311,23,20,43,0.138,1082,RW,1988,1995
Matt Johnson,473,23,20,43,0.091,1523,LW,1994,2004
Rob Klinkhammer,193,22,21,43,0.223,64,W/C,2010,2016
Zellio Toppazzini,123,21,22,43,0.35,49,RW,1948,1957
Adam Cracknell,210,21,22,43,0.205,46,RW/C,2010,2019
Tom Wandell,229,20,23,43,0.188,52,C,2008,2013
Joakim Lindstrom,150,19,24,43,0.287,58,RW,2005,2015
Chris Herperger,169,18,25,43,0.254,75,C,1999,2003
Vyacheslav Butsayev,132,17,26,43,0.326,133,C,1992,2000
Tim Bergland,182,17,26,43,0.23600000000000002,75,RW,1989,1994
Jeff Daniels,425,17,26,43,0.10099999999999999,83,LW,1990,2003
Mike Moller,134,15,28,43,0.321,41,RW,1980,1987
Murray Brumwell,128,12,31,43,0.336,70,D,1980,1988
Blake Sloan,290,11,32,43,0.14800000000000002,162,D,1998,2004
Doug Berry,121,10,33,43,0.355,25,C,1979,1981
Roger Johansson,161,9,34,43,0.267,163,D,1989,1995
Ted McAneeley,158,8,35,43,0.272,141,D,1972,1975
Ryan Murphy,175,8,35,43,0.24600000000000002,54,D,2012,2019
Bart Crashley,140,7,36,43,0.307,50,D,1965,1976
Eric Gryba,289,7,36,43,0.149,368,D,2012,2019
Simon Despres,193,6,37,43,0.223,150,D,2011,2017
John Grisdale,250,4,39,43,0.172,346,D,1972,1979
Enver Lisin,135,24,18,42,0.311,64,RW,2006,2010
Jaroslav Svejkovsky,113,23,19,42,0.37200000000000005,56,RW,1996,2000
Tony Demers,83,20,22,42,0.506,23,RW,1937,1944
Reid Boucher,133,20,22,42,0.316,18,LW/RW,2013,2019
Krys Kolanos,149,20,22,42,0.282,94,C/W,2001,2012
Daniel Vincelette,193,20,22,42,0.218,351,LW,1986,1992
Jordan Schroeder,165,18,24,42,0.255,14,C/RW,2012,2018
Zac Rinaldo,370,18,24,42,0.114,753,C/W,2010,2020
Normand Leveille,75,17,25,42,0.56,49,LW,1981,1983
Chris Lindberg,116,17,25,42,0.36200000000000004,47,C,1991,1994
George Swarbrick,132,17,25,42,0.318,173,RW,1967,1971
Wilf Field,219,17,25,42,0.192,151,D,1936,1945
Brian Lavender,184,16,26,42,0.228,174,LW,1971,1975
Stan Drulia,126,15,27,42,0.33299999999999996,52,RW,1992,2001
Brett Howden,140,15,27,42,0.3,42,C,2018,2021
Ladislav Kohn,186,14,28,42,0.226,125,RW,1995,2003
Larry Leach,126,13,29,42,0.33299999999999996,91,C,1958,1962
Elwyn Morris,135,13,29,42,0.311,58,D,1943,1949
MacKenzie Weegar,174,13,29,42,0.24100000000000002,133,D,2016,2021
Peter Harrold,274,13,29,42,0.153,74,D/W,2006,2015
Robert Dirk,402,13,29,42,0.10400000000000001,772,D,1987,1996
Doug Lecuyer,126,11,31,42,0.33299999999999996,178,LW,1978,1983
Robert Hagg,207,11,31,42,0.203,127,D,2016,2021
Eric Cairns,457,10,32,42,0.092,1182,D,1996,2008
Nathan Paetsch,167,7,35,42,0.251,114,D,2005,2010
Donald Dufresne,268,6,36,42,0.157,258,D,1988,1997
Larry Hale,196,5,37,42,0.214,90,D,1968,1972
Tom Tilley,174,4,38,42,0.24100000000000002,89,D,1988,1994
Louie DeBrusk,401,24,17,41,0.102,1161,LW,1991,2003
Dan Bolduc,102,22,19,41,0.402,33,LW,1978,1984
Larry DePalma,148,21,20,41,0.27699999999999997,408,LW,1985,1994
Petteri Nokelainen,245,20,21,41,0.16699999999999998,103,C,2005,2012
Darcy Hordichuk,542,20,21,41,0.076,1140,LW,2000,2013
Fabian Brunnstrom,104,19,22,41,0.39399999999999996,22,RW,2008,2012
John Flesch,124,18,23,41,0.331,117,LW/D,1974,1980
Dan Newman,126,17,24,41,0.325,63,LW,1976,1980
Tom Miller,118,16,25,41,0.34700000000000003,34,F,1970,1975
Philippe Bozon,144,16,25,41,0.285,101,RW,1991,1995
Ken Doraty,103,15,26,41,0.39799999999999996,24,RW,1926,1938
Mike Watt,157,15,26,41,0.261,41,C,1997,2003
Charles Hudon,125,14,27,41,0.32799999999999996,56,LW/RW,2015,2020
Zack Stortini,257,14,27,41,0.16,725,RW,2006,2012
Art Wiebe,414,14,27,41,0.099,201,D,1932,1944
Fred Hucul,164,11,30,41,0.25,113,D,1950,1968
Jeff Jillson,140,9,32,41,0.293,96,D,2001,2006
Travis Dermott,163,9,32,41,0.252,71,D,2017,2021
Michael Volcan,162,8,33,41,0.253,146,D,1980,1984
John Blum,250,7,34,41,0.16399999999999998,610,D,1982,1990
Allen Pedersen,428,5,36,41,0.096,487,D,1986,1994
Greg Pateryn,272,4,37,41,0.151,164,D,2012,2021
Randy Holt,395,4,37,41,0.10400000000000001,1438,D,1974,1984
Jack McDonald,70,26,14,40,0.5710000000000001,30,LW,1917,1922
Frank Ingram,101,24,16,40,0.396,69,RW,1929,1932
Tyler Motte,193,24,16,40,0.207,48,C/W,2016,2021
Andrew Murray,221,24,16,40,0.18100000000000002,36,C/LW,2007,2013
Robert Heron,106,21,19,40,0.377,38,LW,1938,1942
John Brenneman,152,21,19,40,0.263,46,LW,1964,1969
Mike Zigomanis,197,21,19,40,0.203,89,C,2002,2011
Joe Simpson,228,21,19,40,0.175,156,D,1925,1931
Edmond Bouchard,211,19,21,40,0.19,117,LW,1921,1929
Pyotr Schastlivy,129,18,22,40,0.31,30,C,1999,2004
Paul Runge,140,18,22,40,0.28600000000000003,57,C,1930,1938
Jim Roberts,106,17,23,40,0.377,33,F,1976,1979
Ryan Bayda,179,16,24,40,0.223,94,LW/C,2002,2009
Gerry James,149,14,26,40,0.268,257,RW,1954,1960
Mark Greig,125,13,27,40,0.32,90,RW,1990,2003
Red Goupille,222,12,28,40,0.18,256,D,1935,1943
Clare Martin,237,12,28,40,0.16899999999999998,78,D,1941,1952
Brent Severyn,328,10,30,40,0.122,825,D,1989,1999
Steve Dykstra,217,8,32,40,0.184,545,D,1985,1990
Bob Halkidis,256,8,32,40,0.156,825,D,1984,1996
Brian Curran,381,7,33,40,0.105,1361,D,1983,1994
Johnny McKinnon,208,28,11,39,0.188,224,D,1925,1931
John LeBlanc,83,26,13,39,0.47,28,RW,1986,1995
William Carrier,208,21,18,39,0.188,112,LW,2016,2021
Steve Wojciechowski,54,19,20,39,0.722,17,RW,1944,1947
Ken Solheim,135,19,20,39,0.289,34,LW,1980,1986
Martin Frk,117,18,21,39,0.33299999999999996,22,RW,2016,2021
Martin Necas,75,17,22,39,0.52,22,C/RW,2017,2021
Casey Mittelstadt,114,17,22,39,0.342,14,C/W,2017,2021
Stu Grimson,729,17,22,39,0.053,2113,LW,1988,2002
Ken Kilrea,88,16,23,39,0.44299999999999995,8,LW,1938,1944
Mark Freer,124,16,23,39,0.315,61,C,1986,1994
Cam Stewart,202,16,23,39,0.193,120,LW,1993,2001
Darren Langdon,521,16,23,39,0.075,1251,LW,1994,2006
Connie Brown,73,15,24,39,0.534,12,C,1938,1943
Dave Donnelly,137,15,24,39,0.285,150,C,1983,1988
Tim Kennedy,162,15,24,39,0.24100000000000002,60,C/LW,2008,2014
Paul Evans,103,14,25,39,0.379,34,C,1978,1983
Ted Graham,346,14,25,39,0.113,300,D,1927,1937
Dale Henry,132,13,26,39,0.295,263,LW,1984,1990
Gary Shuchuk,142,13,26,39,0.275,70,C,1990,1996
Andrew Hutchinson,140,12,27,39,0.27899999999999997,70,D,2003,2011
Jean-Francois Jomphe,111,10,29,39,0.35100000000000003,102,C,1995,1999
Gord Smith,299,9,30,39,0.13,284,D,1974,1980
Dick Mattiussi,200,8,31,39,0.195,124,D,1967,1971
Madison Bowey,154,5,34,39,0.253,104,D,2017,2020
Ryan O'Byrne,308,5,34,39,0.127,369,D,2007,2013
Alex Biega,229,4,35,39,0.17,118,D,2014,2021
Bill Plager,263,4,35,39,0.14800000000000002,294,D,1967,1976
Alf Skinner,71,26,12,38,0.535,93,RW,1917,1926
Chris Terry,152,22,16,38,0.25,34,LW/RW,2012,2017
Dave Hindmarch,99,21,17,38,0.384,25,RW,1980,1984
Des Roche,113,20,18,38,0.336,44,RW,1930,1935
Clarence Abel,333,20,18,38,0.114,361,D,1926,1934
Earl Anderson,109,19,19,38,0.349,22,RW,1974,1977
Jeremy Stevenson,207,19,19,38,0.184,451,LW,1995,2006
Douglas Palazzari,108,18,20,38,0.35200000000000004,23,C,1974,1979
Joe Contini,68,17,21,38,0.5589999999999999,34,C,1977,1981
George Morrison,115,17,21,38,0.33,13,LW,1970,1972
Johnny Pohl,115,17,21,38,0.33,24,C,2003,2008
Tony Featherstone,130,17,21,38,0.292,65,RW,1969,1974
Jesse Puljujarvi,145,17,21,38,0.262,42,RW,2016,2021
David Nemirovsky,91,16,22,38,0.418,42,RW,1995,1999
Jean-Yves Leroux,220,16,22,38,0.17300000000000001,146,LW,1996,2001
Eric Nickulas,118,15,23,38,0.322,82,RW,1998,2006
Jack McLean,67,14,24,38,0.5670000000000001,76,F,1942,1945
Austin Czarnik,121,13,25,38,0.314,20,C/RW,2016,2021
Hugh Harris,60,12,26,38,0.633,17,C,1972,1973
T.J. Hensick,112,12,26,38,0.33899999999999997,18,C/RW,2007,2011
Shane Prince,128,12,26,38,0.297,39,LW/RW,2014,2018
Konstantin Koltsov,144,12,26,38,0.264,50,LW/RW,2002,2006
Zach Redmond,133,9,29,38,0.28600000000000003,50,D,2012,2018
Dalton Prout,264,7,31,38,0.14400000000000002,321,D,2011,2020
Bud MacPherson,259,5,33,38,0.147,233,D,1948,1957
Jamie Huscroft,352,5,33,38,0.10800000000000001,1065,D,1988,2000
Herb Drury,213,24,13,37,0.174,203,D,1925,1931
Dean Sylvester,96,21,16,37,0.385,32,RW,1998,2001
Nikita Alexeyev,156,20,17,37,0.237,28,RW/LW,2001,2007
Tim Stapleton,118,19,18,37,0.314,24,C/RW,2008,2012
Lou Jankowski,127,19,18,37,0.29100000000000004,15,C,1950,1955
Robert Sullivan,62,18,19,37,0.597,18,LW,1982,1983
David Pasin,76,18,19,37,0.48700000000000004,50,C,1985,1989
Dan Johnson,121,18,19,37,0.306,24,C,1969,1972
Aaron Voros,162,18,19,37,0.228,395,LW/RW,2007,2011
Mike Lampman,96,17,20,37,0.385,34,LW,1972,1977
Nathan LaFayette,187,17,20,37,0.198,103,C,1993,1999
Vadim Sharifyanov,92,16,21,37,0.402,50,LW,1996,2000
Michael Amadio,151,16,21,37,0.245,24,C/RW,2017,2021
Donald Laurence,79,15,22,37,0.46799999999999997,14,C,1978,1980
John Chad,80,15,22,37,0.46299999999999997,29,RW,1939,1946
Mike Tomlak,141,15,22,37,0.262,103,C,1989,1994
Ed Kryzanowski,237,15,22,37,0.156,65,D,1948,1953
Jeff Lazaro,102,14,23,37,0.363,114,RW,1990,1993
Jackie McLeod,106,14,23,37,0.349,12,RW,1949,1955
Nick Johnson,113,14,23,37,0.327,52,RW,2009,2014
Scott Garland,91,13,24,37,0.40700000000000003,115,LW,1975,1979
Dave Feamster,169,13,24,37,0.21899999999999997,154,D,1981,1985
Alexander Svitov,179,13,24,37,0.207,223,C,2002,2007
Jacob de la Rose,229,13,24,37,0.162,77,LW/C,2014,2021
Rick Foley,67,11,26,37,0.552,180,D,1970,1974
Hannu Jarvenpaa,114,11,26,37,0.325,83,RW,1986,1989
Maitland Conn,96,9,28,37,0.385,22,LW,1933,1935
Bob Hassard,126,9,28,37,0.294,22,C,1949,1955
Philip Larsen,151,9,28,37,0.245,46,D,2009,2017
Garth Boesch,197,9,28,37,0.188,205,D,1946,1950
Vladimir Vujtek,110,7,30,37,0.336,38,RW,1991,2003
Miles Zaharko,129,5,32,37,0.287,84,D,1977,1982
Paul Curtis,185,3,34,37,0.2,161,D,1969,1973
Gord Fraser,144,24,12,36,0.25,224,D,1926,1931
Kraig Nienhuis,87,20,16,36,0.414,39,LW,1985,1988
Church Russell,90,20,16,36,0.4,12,F,1945,1948
Brent Grieve,97,20,16,36,0.371,87,LW,1993,1997
Brad Gassoff,122,19,17,36,0.295,163,LW,1975,1979
Brendan Lemieux,135,19,17,36,0.267,244,LW,2017,2021
Mike Brown,407,19,17,36,0.08800000000000001,778,RW,2007,2016
Mike Millar,78,18,18,36,0.462,12,RW,1986,1991
Zach Aston-Reese,116,18,18,36,0.31,56,C/W,2017,2021
Reid Simpson,301,18,18,36,0.12,838,LW,1991,2004
George Parros,474,18,18,36,0.076,1092,RW,2005,2014
George Boothman,58,17,19,36,0.621,18,C,1942,1944
Teodors Blugers,102,17,19,36,0.353,40,C/LW,2018,2021
Daniel Carr,111,16,20,36,0.324,26,LW/RW,2015,2021
Ed Hoekstra,70,15,21,36,0.514,6,C,1967,1968
Brian Ogilvie,90,15,21,36,0.4,29,C,1972,1979
Bob Bailey,150,15,21,36,0.24,207,RW,1953,1958
Andreas Nodl,183,15,21,36,0.19699999999999998,28,RW,2008,2013
Joakim Andersson,205,15,21,36,0.17600000000000002,48,C,2011,2016
Logan Shaw,215,15,21,36,0.16699999999999998,35,RW/C,2015,2020
Kailer Yamamoto,59,14,22,36,0.61,22,RW/LW,2017,2021
Brandon McMillan,171,14,22,36,0.21100000000000002,60,C/LW,2010,2015
Wayne Hicks,115,13,23,36,0.313,22,RW,1959,1968
Ed Ronan,182,13,23,36,0.198,101,RW,1991,1997
Bernie Johnston,57,12,24,36,0.632,16,C,1979,1981
Johnny Mahaffy,37,11,25,36,0.973,4,C,1942,1945
Bill Benson,67,11,25,36,0.537,35,C,1940,1942
Bob McManama,99,11,25,36,0.364,28,C,1973,1976
David Wilkie,167,10,26,36,0.21600000000000003,165,D,1994,2001
Darren Rumble,193,10,26,36,0.187,214,D,1990,2004
Joe Shack,70,9,27,36,0.514,20,F,1942,1945
Cory Murphy,91,9,27,36,0.396,38,D,2007,2010
Wade Campbell,213,9,27,36,0.16899999999999998,305,D,1982,1988
Brett Kulak,219,8,28,36,0.16399999999999998,90,D,2014,2021
Steve Poapst,307,8,28,36,0.11699999999999999,173,D,1995,2006
Jerome Dupont,214,7,29,36,0.168,468,D,1981,1987
Bryan Lefley,228,7,29,36,0.158,101,D,1972,1978
Brett Harkins,78,6,30,36,0.462,22,C,1994,2002
Jim O'Neil,156,6,30,36,0.231,109,RW,1933,1942
Brian Lee,209,5,31,36,0.172,124,D,2007,2014
Mike Lundin,252,4,32,36,0.14300000000000002,54,D,2007,2013
Lonny Bohonos,83,19,16,35,0.42200000000000004,22,C,1995,1999
Mathieu Joseph,110,19,16,35,0.318,42,RW/LW,2018,2021
Herb Dickenson,48,18,17,35,0.7290000000000001,10,LW,1951,1953
Don O'Donoghue,125,18,17,35,0.28,35,RW,1969,1972
Michael Holmqvist,156,18,17,35,0.22399999999999998,72,C,2003,2007
Matt Frattin,135,17,18,35,0.259,44,LW/RW,2010,2015
John Kordic,244,17,18,35,0.14300000000000002,997,RW,1985,1992
Max McNab,128,16,19,35,0.273,24,C,1947,1951
Jeff Parker,141,16,19,35,0.248,163,RW,1986,1991
Steve Gatzos,89,15,20,35,0.39299999999999996,83,RW,1981,1985
Jack Shill,160,15,20,35,0.21899999999999997,70,LW,1933,1939
Ken McRae,137,14,21,35,0.255,364,RW,1987,1994
Gordon Sherven,97,13,22,35,0.361,33,C,1983,1988
Gary Sampson,105,13,22,35,0.33299999999999996,25,F,1983,1987
Sam Steel,92,12,23,35,0.38,30,C/LW,2018,2021
Krys Barch,381,12,23,35,0.092,812,RW/LW,2006,2014
Craig MacDonald,233,11,24,35,0.15,91,C,1998,2009
Paul Postma,205,10,25,35,0.171,51,D,2010,2018
Anton Lander,215,10,25,35,0.163,56,C,2011,2017
Rory Fitzpatrick,287,10,25,35,0.122,201,D,1995,2008
Stew Adams,95,9,26,35,0.368,60,LW,1929,1933
Jan Rutta,130,9,26,35,0.26899999999999996,60,D,2017,2021
Kyle Cumiskey,139,9,26,35,0.252,48,D,2006,2015
Per Gustafsson,89,8,27,35,0.39299999999999996,38,D,1996,1998
Sean Walker,112,8,27,35,0.313,36,D,2018,2021
Taylor Fedun,127,8,27,35,0.276,44,D,2013,2021
Marc Chorney,210,8,27,35,0.16699999999999998,209,D,1980,1984
Jean Gauthier,166,6,29,35,0.21100000000000002,150,D,1960,1970
Sami Lepisto,176,6,29,35,0.19899999999999998,137,D,2007,2012
David Fenyves,206,3,32,35,0.17,119,D,1982,1991
Denis Guryanov,87,22,12,34,0.391,15,RW/LW,2016,2021
Bill Shill,79,21,13,34,0.43,18,RW,1942,1947
Bert McInenly,166,19,15,34,0.205,144,D,1930,1936
Art Duncan,156,18,16,34,0.218,225,D,1926,1931
Bill Huard,223,16,18,34,0.152,594,LW,1992,2000
Chris Murray,242,16,18,34,0.14,550,RW,1994,2000
Alexander Perezhogin,128,15,19,34,0.266,86,LW/RW,2005,2007
Chris Porter,234,15,19,34,0.145,39,LW,2008,2016
Chris Dingman,385,15,19,34,0.08800000000000001,769,LW,1997,2006
Frank Spring,61,14,20,34,0.557,12,RW,1969,1977
Anders Bjork,112,14,20,34,0.304,20,LW/RW,2017,2021
Jarrod Skalde,115,13,21,34,0.29600000000000004,62,C,1990,2002
Steven Kampfer,211,13,21,34,0.161,106,D,2010,2020
Pascal Trepanier,229,12,22,34,0.14800000000000002,252,D,1997,2003
Vladimir Krutov,61,11,23,34,0.557,20,LW,1989,1990
Ossie Asmundson,111,11,23,34,0.306,30,C,1932,1938
Paul Guay,117,11,23,34,0.29100000000000004,92,RW,1983,1991
Bill Root,247,11,23,34,0.138,180,D,1982,1988
Jim Montgomery,122,9,25,34,0.27899999999999997,80,C,1993,2003
Jari Gronstrand,185,8,26,34,0.184,135,D,1986,1991
Lars-Erik Sjoberg,79,7,27,34,0.43,48,D,1979,1980
Scott Harrington,191,6,28,34,0.17800000000000002,65,D,2014,2021
Jim Paek,217,5,29,34,0.157,155,D,1990,1995
Dave Logan,218,5,29,34,0.156,470,D,1975,1981
Martin Marincin,227,5,29,34,0.15,110,D,2013,2020
Brad Ference,250,4,30,34,0.136,565,D,1999,2007
Mark Fistric,325,4,30,34,0.105,284,D,2007,2015
George Carey,72,21,12,33,0.45799999999999996,20,RW,1919,1924
Earl Miller,109,19,14,33,0.303,124,LW,1927,1932
Austin Wagner,130,18,15,33,0.254,55,LW,2018,2021
Dustin Jeffrey,131,18,15,33,0.252,12,LW/C,2008,2016
Greg McKegg,185,18,15,33,0.17800000000000002,57,C/W,2013,2021
Bob Barlow,77,16,17,33,0.429,10,LW,1969,1971
Paul Marshall,95,15,18,33,0.34700000000000003,17,LW,1979,1983
Stephen Johns,167,15,18,33,0.198,93,D,2015,2021
Drayson Bowman,180,15,18,33,0.183,53,W/C,2009,2015
Darryl Maggs,135,14,19,33,0.244,54,D,1971,1980
John Gallagher,205,14,19,33,0.161,153,D,1930,1939
Scott Levins,124,13,20,33,0.266,316,C,1992,1998
Jiri Dopita,73,12,21,33,0.452,19,C,2001,2003
Jake Dowell,157,11,22,33,0.21,133,C,2007,2014
Barry Melrose,300,10,23,33,0.11,728,D,1979,1986
Nikita Nesterov,135,9,24,33,0.244,81,D,2014,2021
Ilya Byakin,57,8,25,33,0.579,44,D,1993,1995
Peter Scamurra,132,8,25,33,0.25,59,D,1975,1980
Wade Belak,549,8,25,33,0.06,1263,RW/D,1996,2011
Anders Carlsson,104,7,26,33,0.317,34,C,1986,1989
Alexei Semyonov,211,7,26,33,0.156,249,D,2002,2009
Benny Woit,334,7,26,33,0.099,170,D,1950,1957
Kurt Sauer,356,5,28,33,0.09300000000000001,250,D,2002,2012
Justin Falk,279,3,30,33,0.11800000000000001,219,D,2009,2019
Par Djoos,82,2,31,33,0.402,58,D,1990,1993
Pete Bellefeuille,92,26,6,32,0.348,58,RW,1925,1930
Duke McCurry,148,21,11,32,0.21600000000000003,119,LW,1925,1929
Ozzie Aubuchon,50,20,12,32,0.64,4,LW,1942,1944
George Johnston,58,20,12,32,0.552,2,RW,1941,1947
Harry Meeking,64,19,13,32,0.5,68,LW,1917,1927
Steve McKenna,373,18,14,32,0.086,824,D/LW,1996,2004
Joe Matte,68,17,15,32,0.47100000000000003,54,F,1919,1926
James Jarvis,112,17,15,32,0.28600000000000003,62,LW,1929,1937
Robert Cimetta,103,16,16,32,0.311,66,LW,1988,1992
Jean-Marc Lanthier,105,16,16,32,0.305,29,RW,1983,1988
Alex Faulkner,101,15,17,32,0.317,15,C,1961,1964
Adam Erne,172,15,17,32,0.18600000000000003,90,LW/RW,2016,2021
Jim Hamilton,95,14,18,32,0.337,28,LW,1977,1985
Cliff Schmautz,56,13,19,32,0.5710000000000001,33,RW,1970,1971
Alexander Nylander,84,13,19,32,0.381,14,W/C,2016,2021
Dan Sexton,88,13,19,32,0.364,20,RW,2009,2011
Murray Costello,162,13,19,32,0.198,54,C,1953,1957
Mathias Tjarnqvist,173,13,19,32,0.185,60,LW,2003,2008
Robert Fitchner,78,12,20,32,0.41,59,C,1979,1981
Vitali Karamnov,92,12,20,32,0.348,65,LW,1992,1995
Ryan Graves,100,12,20,32,0.32,49,D,2018,2021
Radovan Somik,113,12,20,32,0.28300000000000003,27,RW/LW,2002,2004
Jamie Wright,124,12,20,32,0.258,54,LW,1997,2003
Gerry Minor,140,11,21,32,0.22899999999999998,173,C,1979,1984
Chris Taylor,149,11,21,32,0.215,48,C,1994,2004
Micheal Haley,270,11,21,32,0.11900000000000001,687,C/W,2009,2021
Jack Riley,104,10,22,32,0.308,8,C,1932,1936
Wyatt Smith,211,10,22,32,0.152,65,C,1999,2008
Josh Langfeld,143,9,23,32,0.22399999999999998,60,RW,2001,2008
Joe Morrow,162,9,23,32,0.198,62,D,2014,2019
Linus Omark,79,8,24,32,0.405,40,LW,2010,2014
Leif Rohlin,96,8,24,32,0.33299999999999996,40,D,1995,1997
Ville Koistinen,103,8,24,32,0.311,40,D,2007,2010
Corey Potter,130,8,24,32,0.24600000000000002,53,D,2008,2016
Bill Baker,143,7,25,32,0.22399999999999998,175,D,1980,1983
Jon Rohloff,150,7,25,32,0.213,129,D,1994,1997
John Hanna,198,6,26,32,0.162,206,D,1958,1968
Rick Wilson,239,6,26,32,0.134,165,D,1973,1977
Brad Berry,241,4,28,32,0.133,323,D,1985,1994
Daniel Sprong,100,19,12,31,0.31,10,RW/LW,2015,2021
Denis Hamel,192,19,12,31,0.161,77,LW,1999,2007
Norm Aubin,69,18,13,31,0.449,30,C,1981,1983
Mats Hallin,152,17,14,31,0.204,193,LW,1982,1987
Scott Fraser,71,16,15,31,0.43700000000000006,24,C,1995,1999
Jack Stoddard,80,16,15,31,0.38799999999999996,31,RW,1951,1953
Dave Chyzowski,126,15,16,31,0.24600000000000002,144,LW,1989,1997
Bill Summerhill,72,14,17,31,0.431,70,RW,1937,1942
Kevin O'Shea,133,13,18,31,0.233,85,RW,1970,1973
Jimmy Jones,148,13,18,31,0.209,68,RW,1977,1980
Frederik Gauthier,168,13,18,31,0.185,45,C,2015,2021
Jorgen Jonsson,79,12,19,31,0.392,16,C,1999,2000
Claude Boivin,132,12,19,31,0.235,364,LW,1991,1995
Gerry Odrowski,309,12,19,31,0.1,111,D,1960,1972
Steve Black,113,11,20,31,0.27399999999999997,77,LW,1949,1951
Jan Vopat,126,11,20,31,0.24600000000000002,70,D,1995,2000
Joseph Blandisi,101,10,21,31,0.307,78,C/LW,2015,2020
Brent Meeke,75,9,22,31,0.413,8,F,1972,1977
Neil Brady,89,9,22,31,0.348,95,C,1989,1994
Cam Connor,89,9,22,31,0.348,256,RW,1978,1983
Petr Buzek,157,9,22,31,0.19699999999999998,94,D,1997,2003
Travis Boyd,85,8,23,31,0.365,10,C,2017,2020
Kevin Dallman,154,8,23,31,0.201,45,D,2005,2008
Ivan Majesky,202,8,23,31,0.153,234,D,2002,2006
Chris Luongo,218,8,23,31,0.142,176,D,1990,1996
Aut Erickson,226,7,24,31,0.13699999999999998,182,D,1959,1970
Jimmy Orlando,199,6,25,31,0.156,375,D,1936,1943
Rudy Poeschek,364,6,25,31,0.085,817,D/RW,1987,2000
Murray Patrick,166,5,26,31,0.187,133,D,1937,1946
Paul Terbenche,189,5,26,31,0.16399999999999998,28,D,1967,1974
Victor Mete,171,4,27,31,0.18100000000000002,30,D,2017,2021
Francis Bathe,224,3,28,31,0.138,542,D,1974,1984
Marty Howe,197,2,29,31,0.157,99,D,1979,1985
Vitali Prokhorov,83,19,11,30,0.361,35,LW,1992,1995
Mark Hartigan,102,19,11,30,0.294,58,C,2001,2008
Alex McKinnon,193,19,11,30,0.155,237,F,1924,1929
Bob Dill,76,15,15,30,0.395,135,D,1943,1945
Dave Roche,171,15,15,30,0.175,334,LW,1995,2002
Ramzi Abid,68,14,16,30,0.441,78,LW/C,2002,2007
Scott Parse,73,14,16,30,0.41100000000000003,36,RW/LW,2009,2012
Nick Paul,116,14,16,30,0.259,34,LW/C,2015,2021
Marian Cisar,73,13,17,30,0.41100000000000003,57,RW,1999,2002
Ty Rattie,98,13,17,30,0.306,12,RW,2013,2019
Brad Malone,199,13,17,30,0.151,198,C/LW,2011,2019
Nick Tarnasky,245,13,17,30,0.122,297,LW/C,2005,2010
Zach Boychuk,127,12,18,30,0.23600000000000002,16,C/LW,2008,2015
Zenon Konopka,346,12,18,30,0.087,1082,C,2005,2014
Mattias Tedenby,120,10,20,30,0.25,42,LW,2010,2014
Jimmy Mann,293,10,20,30,0.102,895,RW,1979,1988
Cam Russell,396,9,21,30,0.076,872,D,1989,1999
Kenny Agostino,85,8,22,30,0.353,40,LW,2013,2019
Dan Kesa,139,8,22,30,0.21600000000000003,66,RW,1993,2000
Slater Koekkoek,155,8,22,30,0.19399999999999998,88,D,2014,2021
Dwight Schofield,211,8,22,30,0.142,631,D,1976,1988
Jamie Allison,372,7,23,30,0.081,639,D,1994,2006
Karel Pilar,90,6,24,30,0.33299999999999996,42,D,2001,2004
Chris McAlpine,289,6,24,30,0.10400000000000001,245,D,1994,2003
Sergei Bautin,132,5,25,30,0.22699999999999998,176,D,1992,1996
Drew Bannister,164,5,25,30,0.183,161,D,1995,2002
Gilles Lupien,226,5,25,30,0.133,416,D,1977,1982
Matt Walker,314,4,26,30,0.096,464,D,2002,2013
Thomas McCarthy,35,22,7,29,0.8290000000000001,10,RW,1919,1921
Russell Oatman,120,20,9,29,0.242,100,LW,1926,1929
John McCreedy,64,17,12,29,0.45299999999999996,25,RW,1941,1945
Fred Hunt,59,15,14,29,0.49200000000000005,6,RW,1940,1945
Bill MacKenzie,264,15,14,29,0.11,145,D,1932,1940
Jody Gage,68,14,15,29,0.426,26,RW,1980,1992
Valeri Karpov,76,14,15,29,0.382,32,RW,1994,1997
Steve Washburn,93,14,15,29,0.312,42,C,1995,2001
Larry Hopkins,60,13,16,29,0.483,26,LW,1977,1983
Ronnie Martin,94,13,16,29,0.309,36,RW,1932,1934
Jaroslav Svoboda,134,12,17,29,0.21600000000000003,62,RW,2001,2006
Dale Craigwell,98,11,18,29,0.29600000000000004,28,C,1991,1994
Steve Kraftcheck,157,11,18,29,0.185,83,D,1950,1959
Trent Whitfield,194,11,18,29,0.149,104,C,1999,2012
Jiri Sekac,108,10,19,29,0.26899999999999996,38,LW,2014,2016
Mark Heaslip,117,10,19,29,0.248,110,RW,1976,1979
Erik Cernak,128,10,19,29,0.22699999999999998,117,D,2018,2021
Tony Horacek,154,10,19,29,0.188,316,LW,1989,1995
Chris Wells,195,9,20,29,0.149,193,C,1995,2000
Rod Pelley,256,9,20,29,0.113,102,C,2006,2012
Derrick Walser,91,8,21,29,0.319,56,D,2001,2007
Dave Fortier,205,8,21,29,0.141,335,LW/D,1972,1977
Kevin Dahl,188,7,22,29,0.154,153,D,1992,2001
Tim Heed,105,6,23,29,0.276,20,D,2016,2020
Brian Strait,187,6,23,29,0.155,91,D,2010,2017
David Hale,327,4,25,29,0.08900000000000001,242,D,2003,2011
Ivan Irwin,181,2,27,29,0.16,214,D,1952,1958
Brad Brown,330,2,27,29,0.08800000000000001,747,D,1996,2004
Kai Nurminen,69,17,11,28,0.406,24,LW,1996,2001
Bill Thomas,87,16,12,28,0.322,18,RW,2005,2012
Jud McAtee,46,15,13,28,0.609,6,LW,1942,1945
Brad Smyth,88,15,13,28,0.318,109,RW,1995,2003
Steve Rooney,154,15,13,28,0.182,496,LW,1984,1989
Joe Dziedzic,130,14,14,28,0.215,131,LW,1995,1999
Lucien Grenier,151,14,14,28,0.185,18,RW,1968,1972
Bernie Lukowich,79,13,15,28,0.354,34,RW,1973,1975
Bert Connelly,87,13,15,28,0.322,37,LW,1934,1938
Jean-Yves Roy,61,12,16,28,0.45899999999999996,26,RW,1994,1998
Lyle Moffat,97,12,16,28,0.289,51,LW,1972,1980
Jordan Caron,157,12,16,28,0.17800000000000002,78,RW/LW,2010,2016
Kirk Bowman,88,11,17,28,0.318,19,LW/C,1976,1979
John Smrke,103,11,17,28,0.272,33,C,1977,1980
Pat Graham,103,11,17,28,0.272,136,LW,1981,1984
Antti Aalto,151,11,17,28,0.185,52,C,1997,2001
Alan Quine,106,10,18,28,0.264,22,C/W,2015,2021
Enrico Ciccone,374,10,18,28,0.075,1469,D,1991,2001
Tony Twist,445,10,18,28,0.063,1121,LW,1989,1999
Frank Mario,53,9,19,28,0.528,24,C,1941,1945
Doug Gibson,63,9,19,28,0.444,0,C,1973,1978
Brandon Convery,72,9,19,28,0.389,36,C,1995,1999
Jack Shewchuk,187,9,19,28,0.15,160,D,1938,1945
Jaroslav Hlinka,63,8,20,28,0.444,16,C/LW,2007,2008
Butch McDonald,66,8,20,28,0.424,2,LW,1939,1945
Troy Terry,86,8,20,28,0.326,8,RW/C,2017,2021
Eddie Mazur,107,8,20,28,0.262,120,LW/D,1950,1957
Brendan Bell,102,7,21,28,0.275,51,D,2005,2012
Fredrik Claesson,155,7,21,28,0.18100000000000002,50,D,2015,2020
George Brown,79,6,22,28,0.354,34,C,1936,1939
Dennis Patterson,138,6,22,28,0.203,67,D,1974,1980
Aaron Rome,226,6,22,28,0.124,185,D,2006,2014
Henri Jokiharju,112,5,23,28,0.25,48,D,2018,2021
Paul MacKinnon,147,5,23,28,0.19,91,D,1979,1984
Xavier Ouellet,172,5,23,28,0.163,80,D,2013,2020
Mirco Muller,185,5,23,28,0.151,61,D,2014,2020
Nate Guenin,205,5,23,28,0.13699999999999998,94,D,2006,2016
Rick Kessell,135,4,24,28,0.207,6,C,1969,1974
Dan Bourbonnais,59,3,25,28,0.475,11,F,1981,1984
Jyrki Jokipakka,150,3,25,28,0.187,34,D,2014,2017
Charles Langlois,151,22,5,27,0.179,189,F,1924,1928
Bob Connors,78,17,10,27,0.34600000000000003,110,D/LW,1926,1930
Walter Jackson,84,16,11,27,0.321,18,LW,1932,1936
Tommy Filmore,117,15,12,27,0.231,33,RW,1930,1934
Lukas Sedlak,162,15,12,27,0.16699999999999998,56,C/LW,2016,2019
Daniel Shank,77,13,14,27,0.35100000000000003,175,RW,1989,1992
Robert Mongrain,81,13,14,27,0.33299999999999996,14,C,1979,1986
Jonathan Hedstrom,83,13,14,27,0.325,48,LW,2002,2006
Russ Romaniuk,102,13,14,27,0.265,63,LW,1991,1996
Miikka Salomaki,167,12,15,27,0.162,76,RW/LW,2014,2020
Frank Jerwa,81,11,16,27,0.33299999999999996,53,LW,1931,1935
Christian Berglund,86,11,16,27,0.314,42,LW,2001,2004
Peter Ahola,123,10,17,27,0.22,137,D,1991,1994
Brian McGrattan,317,10,17,27,0.085,609,RW,2005,2015
Jack Hughes,65,9,18,27,0.415,10,C,2019,2021
Steve Kariya,65,9,18,27,0.415,32,LW,1999,2002
Steve Maltais,120,9,18,27,0.225,53,LW,1989,2001
Gustav Forsling,123,8,19,27,0.22,42,D,2016,2021
Jere Karalahti,149,8,19,27,0.18100000000000002,97,D,1999,2002
Mats Thelin,163,8,19,27,0.166,176,D,1984,1987
Ethan Bear,94,6,21,27,0.287,43,D,2017,2021
Nic Petan,129,6,21,27,0.209,34,W/C,2015,2020
Corey Tropp,149,6,21,27,0.18100000000000002,133,RW,2011,2017
Korbinian Holzer,206,6,21,27,0.131,139,D,2010,2020
Christian Djoos,120,5,22,27,0.225,14,D,2017,2021
Ryan Stanton,120,4,23,27,0.225,71,D,2012,2016
Steve Richmond,159,4,23,27,0.17,514,D,1983,1990
Keaton Ellerby,212,4,23,27,0.127,88,D,2009,2015
Matt Carkner,237,4,23,27,0.114,556,D,2005,2014
Terry Johnson,285,3,24,27,0.095,580,D,1979,1988
Anthony Bitetto,183,2,25,27,0.14800000000000002,122,D,2014,2021
Bill Kendall,131,16,10,26,0.198,28,RW,1933,1938
Luke Adam,90,15,11,26,0.289,36,C/LW,2010,2015
Fred O'Donnell,115,15,11,26,0.226,98,LW,1972,1974
Oscar Moller,87,12,14,26,0.299,22,LW,2008,2011
Ivan Ciernik,89,12,14,26,0.292,32,RW,1997,2004
Joel Perrault,96,12,14,26,0.271,68,C/RW,2005,2011
Carl Mokosak,83,11,15,26,0.313,170,LW,1981,1989
John Hayden,157,11,15,26,0.166,162,C/W,2016,2021
Dick Meissner,171,11,15,26,0.152,37,RW,1959,1965
Drew Shore,94,9,17,26,0.27699999999999997,28,C,2012,2017
Curt Brackenbury,141,9,17,26,0.184,226,LW,1979,1983
Warren Holmes,45,8,18,26,0.578,7,C,1981,1984
Frank Nigro,68,8,18,26,0.382,39,C,1982,1984
Bryan Helmer,146,8,18,26,0.17800000000000002,135,D,1998,2009
Les Cunningham,60,7,19,26,0.433,21,C,1936,1940
Terry Ball,74,7,19,26,0.35100000000000003,26,D,1967,1972
Joel Lundqvist,134,7,19,26,0.19399999999999998,56,C,2006,2009
John Marino,61,6,20,26,0.426,20,D,2019,2021
Gus Kyle,203,6,20,26,0.128,362,D,1949,1952
Doug McCaig,273,6,20,26,0.095,275,D,1941,1951
P.J. Stock,235,5,21,26,0.111,523,D/C,1997,2004
Mike Busniuk,143,3,23,26,0.182,297,F/D,1979,1981
Steven King,67,17,8,25,0.373,75,RW,1992,1996
Jeff Brubaker,178,16,9,25,0.14,512,LW,1979,1989
Art Smith,144,15,10,25,0.174,249,D,1927,1931
Brad Tapper,71,14,11,25,0.35200000000000004,72,RW,2000,2003
Daniel Corso,77,14,11,25,0.325,20,C,2000,2004
Lorne Stamler,116,14,11,25,0.21600000000000003,16,LW,1976,1980
Nick Palmieri,87,13,12,25,0.287,20,RW,2009,2012
Andy Andreoff,173,13,12,25,0.145,216,C/LW,2014,2021
Kaapo Kakko,70,12,13,25,0.35700000000000004,16,RW,2019,2021
George Parsons,78,12,13,25,0.321,20,LW,1936,1939
Zac Dalpe,141,12,13,25,0.177,36,C/RW,2010,2019
Lance Nethery,41,11,14,25,0.61,14,F,1980,1982
Denis Shvidki,76,11,14,25,0.32899999999999996,30,RW,2000,2004
Bob Chrystal,132,11,14,25,0.18899999999999997,112,D,1953,1955
Denis Chasse,132,11,14,25,0.18899999999999997,292,RW,1993,1997
Pavel Vorobyov,57,10,15,25,0.439,38,C,2003,2006
Mike Antonovich,87,10,15,25,0.287,37,LW,1975,1984
Joe Szura,90,10,15,25,0.278,30,C,1967,1969
Joel Farabee,57,9,16,25,0.439,39,LW,2019,2021
Mark LaVarre,78,9,16,25,0.321,58,RW,1985,1988
Blake Lizotte,70,8,17,25,0.35700000000000004,24,C,2018,2021
Stefan Elliott,87,8,17,25,0.287,16,D,2011,2019
Daryl Stanley,189,8,17,25,0.132,408,D/LW,1983,1990
Ralph Bowman,274,8,17,25,0.091,260,D,1933,1940
Igor Liba,37,7,18,25,0.6759999999999999,36,LW,1988,1989
Mike McMahon,57,7,18,25,0.439,102,D,1942,1946
Gord Brooks,70,7,18,25,0.35700000000000004,37,RW,1971,1975
Charlie Mason,95,7,18,25,0.263,44,RW,1934,1939
Ted Snell,104,7,18,25,0.24,22,D/RW,1973,1975
Chad Ruhwedel,174,7,18,25,0.14400000000000002,46,D,2012,2021
Michel Mongeau,54,6,19,25,0.46299999999999997,10,C,1989,1993
Matt Roy,99,6,19,25,0.253,20,D,2018,2021
Norm Johnson,61,5,20,25,0.41,41,C,1957,1960
Bill Speer,130,5,20,25,0.192,79,D,1967,1971
Davis Drewiske,135,5,20,25,0.185,67,D,2008,2013
Kevan Guy,156,5,20,25,0.16,138,D,1986,1992
Scott Campbell,80,4,21,25,0.313,127,D,1979,1982
Justin Holl,87,4,21,25,0.287,47,D,2017,2021
David Rundblad,113,4,21,25,0.221,30,D,2011,2016
George Pesut,92,3,22,25,0.272,130,D,1974,1976
Cody Goloubef,160,3,22,25,0.156,76,D,2011,2020
Jeff Chychrun,262,3,22,25,0.095,744,D,1986,1994
Jim Fahey,92,1,24,25,0.272,67,D,2002,2007
Rodger Smith,210,20,4,24,0.114,172,D,1925,1931
Frank Foyston,64,17,7,24,0.375,32,C,1926,1928
Armand Gaudreault,44,15,9,24,0.545,27,LW,1944,1945
Cameron Mann,93,14,10,24,0.258,40,RW,1997,2003
Jaroslav Balastik,74,13,11,24,0.324,30,LW/RW,2005,2007
Fred Glover,92,13,11,24,0.261,62,C,1948,1953
Gary Holt,101,13,11,24,0.23800000000000002,133,LW,1973,1978
Earl Heiskala,127,13,11,24,0.18899999999999997,294,LW,1968,1971
Jesse Joensuu,129,13,11,24,0.18600000000000003,77,LW,2008,2015
Bob Kirkpatrick,49,12,12,24,0.49,6,C,1942,1943
Sheldon Keefe,125,12,12,24,0.192,78,RW,2000,2003
Wayne Van Dorp,125,12,12,24,0.192,565,LW,1986,1992
Colton Orr,477,12,12,24,0.05,1186,RW,2003,2015
Billy Cupolo,47,11,13,24,0.511,10,RW,1944,1945
Neil Strain,52,11,13,24,0.462,12,LW,1952,1953
Dmitri Nabokov,55,11,13,24,0.436,28,C,1997,2000
Bob Gryp,74,11,13,24,0.324,33,LW,1973,1976
Andre Savage,66,10,14,24,0.364,14,RW,1998,2003
Eddie Kachur,96,10,14,24,0.25,35,RW,1956,1958
Rick Bourbonnais,71,9,15,24,0.33799999999999997,29,RW,1975,1978
Dennis Cholowski,88,9,15,24,0.273,22,D,2018,2021
Peter Ferraro,92,9,15,24,0.261,58,RW,1995,2002
Larry Pleau,94,9,15,24,0.255,22,C,1969,1972
Lorne Duguid,135,9,15,24,0.17800000000000002,57,LW,1931,1937
Aldo Guidolin,182,9,15,24,0.132,117,D/RW,1952,1956
Ilya Mikheyev,45,8,16,24,0.5329999999999999,6,RW/LW,2019,2021
Josh Ho-Sang,53,7,17,24,0.45299999999999996,20,RW,2016,2019
Roger Kortko,79,7,17,24,0.304,28,C,1984,1986
Jonathon Blum,110,7,17,24,0.218,22,D,2010,2015
Dana Tyrell,135,7,17,24,0.17800000000000002,26,C/W,2010,2015
Liam Reddox,100,6,18,24,0.24,34,LW,2007,2011
Patrick Thoresen,106,6,18,24,0.226,66,LW/RW,2006,2008
Jason Doig,158,6,18,24,0.152,285,D,1995,2004
Branislav Mezei,240,5,19,24,0.1,311,D,2000,2008
Adam Clendening,90,4,20,24,0.267,42,D,2014,2021
Joakim Ryan,141,4,20,24,0.17,33,D,2017,2021
Wayne Muloin,147,3,21,24,0.163,93,D,1963,1971
Matt Tennyson,148,3,21,24,0.162,40,D,2012,2021
Joe Hall,38,15,8,23,0.605,185,D,1917,1919
Benn Ferriero,98,14,9,23,0.235,25,RW,2009,2014
Roman Lyashenko,139,14,9,23,0.165,55,C,1999,2003
Pete Palangio,71,13,10,23,0.324,28,LW,1926,1938
Jason King,59,12,11,23,0.39,8,RW,2002,2008
Enio Sclisizzi,81,12,11,23,0.284,26,LW,1946,1953
Tom Martin,92,12,11,23,0.25,259,LW,1984,1990
George Massecar,100,12,11,23,0.23,46,F,1929,1932
Gerry Carson,261,12,11,23,0.08800000000000001,205,D,1928,1937
Chris Cichocki,68,11,12,23,0.33799999999999997,27,RW,1985,1989
Taylor Beck,92,11,12,23,0.25,32,RW,2012,2017
Ken Belanger,248,11,12,23,0.09300000000000001,695,LW,1994,2006
Lonnie Loach,56,10,13,23,0.41100000000000003,29,LW,1992,1994
Dale Kushner,84,10,13,23,0.27399999999999997,215,RW,1989,1992
Curtis McKenzie,99,10,13,23,0.23199999999999998,131,LW,2014,2018
Anton Slepyshev,102,10,13,23,0.225,14,LW/RW,2015,2018
Iiro Pakarinen,134,10,13,23,0.172,18,RW/LW,2014,2018
Brandon Bollig,241,10,13,23,0.095,392,LW/RW,2011,2016
Joe Hardy,63,9,14,23,0.365,51,C,1969,1971
Al Conroy,114,9,14,23,0.20199999999999999,156,C,1991,1994
Gerry Foley,142,9,14,23,0.162,99,RW,1954,1969
Andreas Martinsen,152,9,14,23,0.151,110,LW/RW,2015,2019
Dan Plante,159,9,14,23,0.145,135,RW,1993,1998
Brandon Davidson,174,9,14,23,0.132,78,D,2014,2021
Kirby Dach,64,8,15,23,0.359,24,C/RW,2019,2021
Dillon Dube,73,8,15,23,0.315,10,C/W,2018,2021
Bill Orban,114,8,15,23,0.20199999999999999,67,C,1967,1970
Trent McCleary,192,8,15,23,0.12,134,RW,1995,2000
Dave Hoyda,132,6,17,23,0.174,299,F,1977,1981
Klas Dahlbeck,170,6,17,23,0.135,87,D,2014,2018
Joe DiPenta,174,6,17,23,0.132,110,D,2002,2008
Wayne King,73,5,18,23,0.315,34,C,1973,1976
Martin Cibak,149,5,18,23,0.154,60,C,2001,2006
Mark Astley,75,4,19,23,0.307,92,D,1993,1996
Vlastimil Kroupa,105,4,19,23,0.21899999999999997,66,D,1993,1998
Jack Church,130,4,19,23,0.177,154,D,1938,1946
Haydn Fleury,135,4,19,23,0.17,24,D,2017,2021
Jim Watson,221,4,19,23,0.10400000000000001,345,D,1963,1972
Vitezslav Duris,89,3,20,23,0.258,62,D,1980,1983
Jake Dotchin,103,3,20,23,0.223,112,D,2016,2019
Francois Leroux,249,3,20,23,0.092,577,D,1988,1998
Don Johns,153,2,21,23,0.15,76,D,1960,1968
Victor Bartley,121,1,22,23,0.19,61,D,2012,2017
Bill Boyd,138,15,7,22,0.159,72,RW,1926,1930
Bob Cook,72,13,9,22,0.306,22,RW,1970,1975
Teemu Pulkkinen,83,13,9,22,0.265,32,RW,2013,2017
Michael Bournival,113,12,10,22,0.195,24,W/C,2013,2018
Dick Cherry,145,12,10,22,0.152,45,D,1956,1970
Pavel Brendl,78,11,11,22,0.282,16,RW,2001,2006
Eric Chouinard,90,11,11,22,0.244,14,W/C,2000,2006
Brandon Segal,103,11,11,22,0.214,85,RW,2008,2013
Viktor Tikhonov,111,11,11,22,0.198,40,LW/C,2008,2016
Pete Morin,31,10,12,22,0.71,7,LW,1941,1942
Alan Kuntz,45,10,12,22,0.489,12,LW,1941,1946
Larry Skinner,47,10,12,22,0.46799999999999997,8,C,1976,1980
Grant Stevenson,47,10,12,22,0.46799999999999997,14,C,2005,2006
Tom O'Neill,66,10,12,22,0.33299999999999996,53,RW,1943,1945
Jayce Hawryluk,68,10,12,22,0.324,32,C/RW,2018,2021
Mark Olver,74,10,12,22,0.297,39,C/LW,2010,2013
Jeremy Morin,82,10,12,22,0.268,69,RW/LW,2010,2015
Byron Bitz,97,10,12,22,0.22699999999999998,65,RW,2008,2012
Tage Thompson,111,10,12,22,0.198,34,W/C,2017,2021
Danny Gruen,49,9,13,22,0.449,19,LW,1972,1977
Alain Caron,60,9,13,22,0.36700000000000005,18,RW,1967,1969
David Jensen,69,9,13,22,0.319,22,F,1984,1988
Jose Charbonneau,71,9,13,22,0.31,67,RW,1987,1995
Bill O'Dwyer,120,9,13,22,0.183,108,C,1983,1990
Juha Lind,133,9,13,22,0.165,20,LW,1997,2001
Tommy Westlund,203,9,13,22,0.10800000000000001,48,RW,1999,2003
Tanner Kero,72,8,14,22,0.306,10,C/RW,2015,2018
John Paddock,87,8,14,22,0.253,86,RW,1975,1983
Craig Millar,114,8,14,22,0.193,73,D,1996,2001
Archie Wilcox,208,8,14,22,0.106,158,D,1929,1935
Ray Powell,31,7,15,22,0.71,2,C,1950,1951
Ulf Isaksson,50,7,15,22,0.44,10,F,1982,1983
Milan Marcetta,54,7,15,22,0.40700000000000003,10,C,1966,1969
Alexander Kharitonov,71,7,15,22,0.31,12,LW,2000,2002
Jim Storm,84,7,15,22,0.262,44,LW,1993,1996
Remi Elie,106,7,15,22,0.20800000000000002,28,LW,2016,2019
Alexander Sulzer,131,7,15,22,0.168,44,D,2008,2014
Rich Clune,139,7,15,22,0.158,327,LW,2009,2016
Paul Bissonnette,202,7,15,22,0.109,340,LW,2008,2014
Drake Batherson,47,6,16,22,0.46799999999999997,19,C/RW,2018,2021
Ted Nolan,78,6,16,22,0.282,105,LW,1981,1986
Lasse Kukkonen,159,6,16,22,0.138,90,D,2003,2009
Michael Chaput,169,6,16,22,0.13,78,C/LW,2013,2021
Robert Murray,194,6,16,22,0.113,98,D,1973,1977
Miloslav Horava,80,5,17,22,0.275,38,D,1988,1991
Dylan Olsen,124,5,17,22,0.177,36,D,2011,2016
Bill Mikkelson,147,4,18,22,0.15,105,D,1971,1977
Taylor Chorney,166,4,18,22,0.133,56,D,2008,2018
Mark Fraser,219,4,18,22,0.1,302,D,2006,2015
Dean Chynoweth,241,4,18,22,0.091,667,D,1988,1998
Harry Connor,134,16,5,21,0.157,149,LW,1927,1931
Dave Ritchie,57,15,6,21,0.368,50,D,1917,1926
Walt Atanas,49,13,8,21,0.429,40,RW,1944,1945
Doug Volmar,62,13,8,21,0.33899999999999997,26,RW,1969,1973
Gemel Smith,83,12,9,21,0.253,42,C/W,2016,2021
Cory Emmerton,139,12,9,21,0.151,22,C,2010,2014
John Markell,55,11,10,21,0.382,36,LW/RW,1979,1985
Mike Maneluk,85,11,10,21,0.247,57,LW,1998,2001
Ed Kastelic,220,11,10,21,0.095,719,RW,1985,1992
Maxime Comtois,44,10,11,21,0.47700000000000004,33,LW,2018,2021
Rene Leclerc,87,10,11,21,0.24100000000000002,105,C,1968,1971
Bob Solinger,99,10,11,21,0.212,19,LW,1951,1960
Tom Sestito,154,10,11,21,0.136,499,LW,2007,2017
Brad Staubitz,230,10,11,21,0.091,521,RW,2008,2013
Sam Bettio,44,9,12,21,0.47700000000000004,32,LW,1949,1950
Steve Carlson,52,9,12,21,0.40399999999999997,23,C,1979,1980
Antero Lehtonen,65,9,12,21,0.32299999999999995,14,LW,1979,1980
Chris Jensen,74,9,12,21,0.284,27,RW,1985,1992
Rob Murphy,125,9,12,21,0.168,152,C,1987,1994
Dennis Rasmussen,139,9,12,21,0.151,24,C,2015,2018
Steve Kelly,149,9,12,21,0.141,83,LW,1996,2008
Troy Bodie,159,9,12,21,0.132,172,RW/LW,2008,2015
Ken Richardson,49,8,13,21,0.429,16,C,1974,1979
Todd Hlushko,79,8,13,21,0.266,84,C,1993,1999
Scott Ferguson,218,7,14,21,0.096,310,D,1997,2006
Kevin Maxwell,66,6,15,21,0.318,61,C,1980,1984
Connor Brickley,81,6,15,21,0.259,42,C/W,2015,2019
Victor Desjardins,87,6,15,21,0.24100000000000002,27,C,1930,1932
Scott Parker,308,6,14,21,0.068,699,RW,1998,2008
Rick Shinske,63,5,16,21,0.33299999999999996,10,C,1976,1979
Steven Santini,116,5,16,21,0.18100000000000002,55,D,2015,2020
Michael Kostka,85,4,17,21,0.247,39,D,2012,2016
Anssi Salmela,112,4,17,21,0.188,44,D,2008,2011
Alexei Marchenko,121,4,17,21,0.174,26,D,2013,2017
Chris McAllister,301,4,17,21,0.07,634,D,1997,2004
Shawn Cronin,292,3,18,21,0.07200000000000001,877,D,1988,1995
Edwin Gorman,111,14,6,20,0.18,108,D,1924,1928
Orville Heximer,84,13,7,20,0.23800000000000002,16,LW,1929,1935
Bryan McSheffrey,90,13,7,20,0.222,44,RW,1972,1975
Mitch Lamoureux,73,11,9,20,0.27399999999999997,59,C,1983,1988
Jamie Leach,81,11,9,20,0.247,12,RW,1989,1994
Emil Bemstrom,61,10,10,20,0.32799999999999996,8,RW,2019,2021
Brian Smith,67,10,10,20,0.299,33,LW,1967,1969
Paul Szczechura,92,10,10,20,0.217,34,C/RW,2008,2012
Irwin Boyd,96,10,10,20,0.20800000000000002,30,RW,1931,1944
Vaclav Nedorost,99,10,10,20,0.20199999999999999,34,C/LW,2001,2004
Yves Sarault,106,10,10,20,0.18899999999999997,51,LW,1994,2002
Jayson Megna,121,10,10,20,0.165,30,C/RW,2013,2020
Ryan VandenBussche,310,10,10,20,0.065,702,RW,1996,2006
Filip Zadina,41,9,11,20,0.488,2,RW/LW,2018,2021
Billy Gooden,53,9,11,20,0.377,15,LW,1942,1944
Steve Cardwell,53,9,11,20,0.377,35,LW,1970,1973
Michal Repik,72,9,11,20,0.278,36,RW,2008,2012
Eric Meloche,74,9,11,20,0.27,36,RW,2001,2007
Samuel Blais,85,9,11,20,0.235,34,LW/RW,2017,2021
Trevor Smith,107,9,11,20,0.187,20,C/LW,2008,2017
Leonard Grosvenor,149,9,11,20,0.134,78,C,1927,1933
Jim Hiller,63,8,12,20,0.317,116,RW,1992,1994
Joe Fisher,65,8,12,20,0.308,13,RW,1939,1943
Lorne Davis,95,8,12,20,0.21100000000000002,20,RW,1951,1960
Richard Lintner,112,8,12,20,0.179,54,D,1999,2003
Maxim Galanov,122,8,12,20,0.16399999999999998,44,D,1997,2001
David Mackey,126,8,12,20,0.159,305,LW,1987,1994
Bob Blackburn,135,8,12,20,0.14800000000000002,105,D,1968,1971
Scott Daniels,149,8,12,20,0.134,667,LW,1992,1999
Ed Courtenay,44,7,13,20,0.455,10,RW,1991,1993
David Saunders,56,7,13,20,0.35700000000000004,10,LW,1987,1988
Ken Quinney,59,7,13,20,0.33899999999999997,23,RW,1986,1991
Gerry Plamondon,74,7,13,20,0.27,10,LW,1945,1951
Jean-Luc Grand-Pierre,269,7,13,20,0.07400000000000001,311,D,1998,2004
Jean-Paul Gladu,40,6,14,20,0.5,2,LW,1944,1945
Pavel Torgayev,55,6,14,20,0.364,20,C,1995,2000
Travis Roche,60,6,14,20,0.33299999999999996,24,D,2000,2007
Paul Healey,77,6,14,20,0.26,44,RW,1996,2006
Eddie Rodden,97,6,14,20,0.20600000000000002,60,C/RW,1926,1931
Roman Vopat,133,6,14,20,0.15,253,C,1995,1999
Fred Shero,145,6,14,20,0.138,137,D,1947,1950
Mike Crowley,67,5,15,20,0.299,44,D,1997,2001
Ron Ingram,114,5,15,20,0.175,81,D,1956,1965
Mark Suzor,64,4,16,20,0.313,60,D,1976,1978
Brett Bellemore,121,4,16,20,0.165,79,D,2012,2015
Dale Purinton,181,4,16,20,0.11,578,D,1999,2004
Greg Smyth,229,4,16,20,0.087,783,D,1986,1997
Steve Oleksy,73,3,17,20,0.27399999999999997,110,D,2012,2017
Matt Donovan,69,2,18,20,0.29,28,D,2011,2019
John Bednarski,100,2,18,20,0.2,114,D,1974,1980
John Schella,115,2,18,20,0.174,224,D,1970,1972
Tyson Strachan,186,1,19,20,0.10800000000000001,199,D,2008,2016
Clint Albright,59,14,5,19,0.322,19,C,1948,1949
Derek Laxdal,67,12,7,19,0.284,88,RW,1984,1991
Wally Wilson,53,11,8,19,0.358,18,RW,1947,1948
Justin Papineau,81,11,8,19,0.235,12,C/LW,2001,2004
John McDonald,43,10,9,19,0.442,6,F,1943,1944
Guy Larose,70,10,9,19,0.271,63,C,1988,1995
Cliff Barton,85,10,9,19,0.22399999999999998,22,RW,1929,1940
Kevin Rooney,97,10,9,19,0.196,41,C,2016,2021
Herb Gardiner,108,10,9,19,0.17600000000000002,52,D,1926,1929
Sergei Kalinin,121,10,9,19,0.157,48,RW/C,2015,2017
Henrik Borgstrom,58,9,10,19,0.32799999999999996,6,C,2017,2020
Mike Korney,77,9,10,19,0.247,59,D/RW,1973,1979
Angus Cameron,35,8,11,19,0.5429999999999999,0,C,1942,1943
Len Fontaine,46,8,11,19,0.413,10,RW/C,1972,1974
Michael Rasmussen,65,8,11,19,0.292,31,C/LW,2018,2021
Trevor Moore,71,8,11,19,0.268,10,C/W,2018,2021
Seth Griffith,79,8,11,19,0.24100000000000002,24,C/RW,2014,2018
Rickard Wallin,79,8,11,19,0.24100000000000002,34,C,2002,2010
Mason Appleton,86,8,11,19,0.221,24,C/W,2018,2021
Jean Savard,43,7,12,19,0.442,29,C,1977,1980
Igor Chibirev,45,7,12,19,0.42200000000000004,2,C,1993,1995
Rob Cowie,78,7,12,19,0.244,52,D,1994,1996
Eric Pettinger,98,7,12,19,0.19399999999999998,83,F,1928,1931
Matthew Peca,73,6,13,19,0.26,6,C,2016,2021
Roman Horak,84,6,13,19,0.226,16,C,2011,2014
Boo Nieves,76,5,14,19,0.25,24,C/LW,2016,2020
Oscar Fantenberg,124,5,14,19,0.153,34,D,2017,2020
Jim Mair,76,4,15,19,0.25,49,D,1970,1975
Par Lindholm,105,4,15,19,0.18100000000000002,22,C/LW,2018,2021
Rob Murray,107,4,15,19,0.17800000000000002,111,C,1989,1999
Ryan McGill,151,4,15,19,0.126,391,D,1991,1995
Dennis Vial,242,4,15,19,0.079,794,D,1990,1998
Radim Simek,92,3,16,19,0.207,22,D,2018,2021
Larry Zeidel,158,3,16,19,0.12,198,D,1951,1969
Doug Janik,190,3,16,19,0.1,154,D,2002,2012
Reed Low,256,3,16,19,0.07400000000000001,725,RW,2000,2007
Chris O'Sullivan,62,2,17,19,0.306,16,D,1996,2003
Francois Lacombe,78,2,17,19,0.244,54,D,1968,1980
Dane Jackson,45,12,6,18,0.4,58,RW,1993,1998
Raitis Ivanans,282,12,6,18,0.064,569,LW,2005,2012
Jay Mazur,47,11,7,18,0.38299999999999995,20,RW,1988,1992
Daniel Lacroix,188,11,7,18,0.096,379,LW,1993,2000
Rusty Crawford,38,10,8,18,0.474,117,RW,1917,1919
Alexandre Texier,43,10,8,18,0.419,16,C/W,2018,2021
Lex Chisholm,54,10,8,18,0.33299999999999996,19,C,1939,1941
Steve Larouche,26,9,9,18,0.6920000000000001,10,C,1994,1996
Marko Tuomainen,79,9,9,18,0.228,84,RW,1994,2002
Stan Jackson,86,9,9,18,0.209,84,LW,1921,1927
Wally Schreiber,41,8,10,18,0.439,12,RW,1987,1989
Ken Berry,55,8,10,18,0.327,30,RW,1981,1989
Normand Dube,57,8,10,18,0.316,54,LW,1974,1976
Mike McDougall,61,8,10,18,0.295,43,RW,1978,1983
Randy Wyrozub,100,8,10,18,0.18,10,C,1970,1974
Dody Wood,106,8,10,18,0.17,471,LW,1992,1998
Aaron Downey,243,8,10,18,0.07400000000000001,494,RW,1999,2009
Ike Hildebrand,41,7,11,18,0.439,16,RW,1953,1955
Patrice Tardif,65,7,11,18,0.27699999999999997,78,C,1994,1996
Lennart Petrell,95,7,11,18,0.18899999999999997,49,LW/RW,2011,2013
Kent Carlson,113,7,11,18,0.159,148,D,1983,1989
John Adams,42,6,12,18,0.429,9,LW,1940,1941
Ivan Huml,49,6,12,18,0.36700000000000005,36,W/C,2001,2004
Les Douglas,52,6,12,18,0.34600000000000003,8,C,1940,1947
Tony Salmelainen,70,6,12,18,0.257,30,LW/RW,2003,2007
Darryl Boyce,84,6,12,18,0.214,68,C/W,2007,2012
Glenn Hicks,108,6,12,18,0.16699999999999998,127,LW/D,1979,1981
Philippe Dupuis,116,6,12,18,0.155,62,C/RW,2008,2012
Colton Gillies,154,6,12,18,0.11699999999999999,72,C/W,2008,2013
Eric Godard,335,6,12,18,0.054000000000000006,833,RW,2002,2011
Dave Sacco,35,5,13,18,0.514,22,C,1993,1996
Pavel Rosa,36,5,13,18,0.5,6,RW,1998,2004
Robert Kabel,48,5,13,18,0.375,34,C,1959,1961
Mark Hamway,53,5,13,18,0.34,9,RW,1984,1987
Pat MacLeod,53,5,13,18,0.34,14,D,1990,1996
Mark Vermette,67,5,13,18,0.26899999999999996,33,RW,1988,1992
Paul LaDue,69,5,13,18,0.261,22,D,2016,2020
Vladislav Gavrikov,74,5,13,18,0.243,20,D,2018,2021
Philippe Myers,75,5,13,18,0.24,36,D,2018,2021
Tucker Poolman,82,5,13,18,0.22,24,D,2017,2021
Larry Trader,91,5,13,18,0.198,74,D,1982,1988
Steve Webb,321,5,13,18,0.055999999999999994,532,RW,1996,2004
Magnus Svensson,46,4,14,18,0.391,31,D,1994,1996
Fred Boimistruck,83,4,14,18,0.217,45,D,1981,1983
Casey Nelson,93,4,14,18,0.19399999999999998,33,D,2015,2019
Greg Brown,94,4,14,18,0.191,86,D,1990,1995
Michael Sauer,98,4,14,18,0.184,96,D,2008,2013
Gord Hollingworth,163,4,14,18,0.11,201,D,1954,1958
Marc-Andre Gragnani,78,3,15,18,0.231,36,D,2007,2016
Rob Davison,219,3,15,18,0.08199999999999999,321,D,2002,2010
Ray McKay,140,2,16,18,0.129,102,D,1968,1974
Butch Deadmarsh,137,12,5,17,0.124,155,LW,1970,1975
Andre Faust,47,10,7,17,0.36200000000000004,14,C,1992,1994
Sid Finney,59,10,7,17,0.28800000000000003,4,C,1951,1954
Max Jones,90,10,7,17,0.18899999999999997,50,LW,2018,2021
Quinton Howden,97,10,7,17,0.175,30,C/LW,2012,2017
Roman Cervenka,39,9,8,17,0.436,14,C/LW,2012,2013
Tye McGinn,89,9,8,17,0.191,44,LW/RW,2012,2016
Jean-Francois Jacques,166,9,8,17,0.102,197,LW/C,2005,2012
Roland Cloutier,34,8,9,17,0.5,2,C,1977,1980
Nicolas Aube-Kubel,50,8,9,17,0.34,29,RW/C,2018,2021
Miroslav Ihnacak,56,8,9,17,0.304,39,RW,1985,1989
Joe Bell,62,8,9,17,0.27399999999999997,18,LW,1942,1947
Wayne Maxner,62,8,9,17,0.27399999999999997,48,LW,1964,1966
Phil Varone,97,8,9,17,0.175,26,C/W,2013,2019
Thomas Pock,118,8,9,17,0.14400000000000002,55,D,2003,2009
Mark Cullen,38,7,10,17,0.447,4,C/LW,2005,2012
Bill Knibbs,53,7,10,17,0.321,4,C,1964,1965
Stefan Ustorf,54,7,10,17,0.315,16,C,1995,1997
Valentin Zykov,55,7,10,17,0.309,10,LW/RW,2016,2020
Jim McGeough,57,7,10,17,0.298,32,C,1981,1987
Roman Simicek,63,7,10,17,0.27,59,C,2000,2002
Michel Galarneau,78,7,10,17,0.218,34,RW,1980,1983
Michael Dal Colle,85,7,10,17,0.2,14,LW/RW,2017,2021
Greg Classen,90,7,10,17,0.18899999999999997,48,C/W,2000,2003
Tomas Vincour,95,7,10,17,0.179,12,RW/C,2010,2015
Blair Jones,132,7,10,17,0.129,65,C/RW,2006,2015
Thommy Abrahamsson,32,6,11,17,0.531,16,D,1980,1981
Rudolfs Balcers,51,6,11,17,0.33299999999999996,10,LW,2018,2021
Ari Haanpaa,60,6,11,17,0.28300000000000003,37,LW,1985,1988
Vern Ayres,211,6,11,17,0.081,350,D,1930,1936
Bobby Rivard,27,5,12,17,0.63,4,C,1967,1968
Jim Nahrgang,57,5,12,17,0.298,34,D,1974,1977
Tom O'Regan,61,5,12,17,0.27899999999999997,10,D/LW,1983,1986
Glenn Merkosky,66,5,12,17,0.258,22,C,1981,1990
Hank Monteith,77,5,12,17,0.221,6,LW,1968,1971
Bruce Cassidy,36,4,13,17,0.47200000000000003,10,D,1983,1990
Stefan Ruzicka,55,4,13,17,0.309,47,RW,2005,2008
Murray Eaves,57,4,13,17,0.298,9,C,1980,1990
Brian Swanson,70,4,13,17,0.243,16,C,2000,2004
Tyler Sloan,99,4,13,17,0.172,50,D,2008,2011
Michael Latta,113,4,13,17,0.15,130,C,2013,2016
Derek Meech,144,4,13,17,0.11800000000000001,45,D,2006,2013
Theo Peckham,160,4,13,17,0.106,388,D,2007,2013
Milan Bartovic,50,3,14,17,0.34,26,RW/LW,2002,2006
Peter Wallin,52,3,14,17,0.327,14,RW,1980,1982
Michel Parizeau,59,3,14,17,0.28800000000000003,18,LW,1971,1972
Dylan Reese,78,3,14,17,0.218,40,D,2009,2015
Jimmie Olvestad,111,3,14,17,0.153,40,LW,2001,2003
Jacob Larsson,118,2,15,17,0.14400000000000002,30,D,2016,2021
Harry Hyland,17,14,2,16,0.941,65,RW,1917,1918
Todd Bergen,14,11,5,16,1.143,4,F,1984,1985
Dan Snyder,49,11,5,16,0.327,64,C,2000,2003
Carter Verhaeghe,54,11,5,16,0.29600000000000004,8,C/W,2019,2021
Lloyd Gross,62,11,5,16,0.258,20,LW,1926,1935
Matt Fraser,87,11,5,16,0.184,27,RW/LW,2011,2015
Matt Puempel,87,11,5,16,0.184,30,LW,2014,2019
Rod Zaine,61,10,6,16,0.262,25,C,1970,1972
Vladimir Vorobyov,33,9,7,16,0.485,14,LW,1996,1999
Reginald Thomas,39,9,7,16,0.41,6,C,1979,1980
Igor Radulov,43,9,7,16,0.37200000000000005,22,LW,2002,2004
Rich Chernomaz,51,9,7,16,0.314,18,RW,1981,1992
Matt Luff,53,9,7,16,0.302,11,RW,2018,2021
Ron Hurst,64,9,7,16,0.25,70,RW,1955,1957
Rick Rypien,119,9,7,16,0.134,226,C,2005,2011
Doug Brennan,123,9,7,16,0.13,152,D,1931,1934
Troy Crowder,150,9,7,16,0.107,433,RW,1987,1997
Nikita Soshnikov,87,8,8,16,0.184,26,LW/RW,2015,2019
Paul Carey,100,8,8,16,0.16,20,C/W,2013,2020
Patrick Bordeleau,129,8,8,16,0.124,185,LW,2012,2015
Jack Forsey,19,7,9,16,0.8420000000000001,10,RW,1942,1943
Russ Kopak,24,7,9,16,0.667,0,C,1943,1944
Felix Mancuso,42,7,9,16,0.381,17,RW,1937,1943
Jordan Kyrou,48,7,9,16,0.33299999999999996,12,C/RW,2018,2021
Kevin Brown,64,7,9,16,0.25,28,RW,1994,2000
Don Poile,66,7,9,16,0.242,12,C,1954,1958
Chris Ferraro,74,7,9,16,0.21600000000000003,57,C,1995,2002
Tomas Plihal,89,7,9,16,0.18,26,LW/C,2006,2009
Kevin Westgarth,169,7,9,16,0.095,266,RW,2008,2014
Casey Wellman,54,6,10,16,0.29600000000000004,4,RW/C,2009,2014
Benoit Gratton,58,6,10,16,0.276,58,C,1997,2004
Tony Graboski,66,6,10,16,0.242,24,LW,1940,1943
Don Martineau,90,6,10,16,0.17800000000000002,63,RW,1973,1977
Yan Stastny,91,6,10,16,0.17600000000000002,58,C,2005,2010
Brendan Gaunce,118,6,10,16,0.136,47,C/LW,2015,2020
Anders Steen,42,5,11,16,0.381,22,F,1980,1981
Thomas Forslund,44,5,11,16,0.364,12,LW,1991,1993
Patrick Boileau,48,5,11,16,0.33299999999999996,26,D,1996,2004
Milos Holan,49,5,11,16,0.327,42,D,1993,1996
Martin Strbak,49,5,11,16,0.327,46,D,2003,2004
Mike McNeill,63,5,11,16,0.254,18,RW,1990,1992
Caleb Jones,63,5,11,16,0.254,18,D,2018,2021
Jack Walker,80,5,11,16,0.2,18,LW,1926,1928
Domenic Pittis,86,5,11,16,0.18600000000000003,71,C,1996,2004
Byron Froese,110,5,11,16,0.145,47,C/RW,2015,2018
Dan Mandich,111,5,11,16,0.14400000000000002,303,D,1982,1986
Dave Amadio,125,5,11,16,0.128,163,D,1957,1969
Eric Tangradi,150,5,11,16,0.107,86,LW/C,2009,2019
Adam Boqvist,46,4,12,16,0.348,10,D,2019,2021
Josef Boumedienne,47,4,12,16,0.34,36,D,2001,2004
Christer Olsson,56,4,12,16,0.28600000000000003,24,D,1995,1997
Derek Joslin,116,4,12,16,0.138,63,D,2008,2013
Shawn Heins,125,4,12,16,0.128,154,D,1998,2004
Lance Ward,209,4,12,16,0.077,391,D,2000,2004
Jason Bonsignore,79,3,13,16,0.203,34,C,1994,1999
Derek Boogaard,277,3,13,16,0.057999999999999996,589,LW,2005,2011
John Hughes,70,2,14,16,0.22899999999999998,211,D,1979,1981
David Harlock,212,2,14,16,0.075,188,D,1993,2002
Gary Morrison,43,1,15,16,0.37200000000000005,70,F,1979,1982
Matt Lashoff,74,1,15,16,0.21600000000000003,59,D,2006,2011
Daniel Goneau,53,12,3,15,0.28300000000000003,14,LW,1996,2000
Jesse Spring,133,11,4,15,0.113,74,D,1923,1930
Bob Logan,42,10,5,15,0.35700000000000004,0,RW,1986,1989
Ed Carpenter,45,10,5,15,0.33299999999999996,41,D,1919,1921
MacKenzie MacEachern,80,10,5,15,0.188,43,LW,2018,2021
Kari Jalonen,37,9,6,15,0.405,4,C,1982,1984
Rod Morrison,34,8,7,15,0.441,4,RW,1947,1948
Pierre Engvall,49,8,7,15,0.306,8,LW/RW,2019,2021
Eddie Cooper,49,8,7,15,0.306,46,LW,1980,1982
Herberts Vasiljevs,51,8,7,15,0.294,22,C,1998,2002
Sergei Varlamov,63,8,7,15,0.23800000000000002,26,LW/C,1997,2003
Fred Gordon,81,8,7,15,0.185,68,RW,1926,1928
Markus Hannikainen,91,8,7,15,0.165,14,LW/RW,2015,2019
Antti Tormanen,50,7,8,15,0.3,28,LW,1995,1996
George Konik,52,7,8,15,0.28800000000000003,26,D,1967,1968
Jacques Locas,59,7,8,15,0.254,66,RW,1947,1949
Max Lajoie,62,7,8,15,0.242,20,D,2018,2020
Carson Soucy,63,7,8,15,0.23800000000000002,20,D,2017,2021
Brian Dobbin,63,7,8,15,0.23800000000000002,61,RW,1986,1992
Michael Ryan,83,7,8,15,0.18100000000000002,34,C/W,2006,2009
Dan Lambert,29,6,9,15,0.517,22,D,1990,1992
Hubert Macey,30,6,9,15,0.5,0,LW,1941,1947
Vic Myles,45,6,9,15,0.33299999999999996,57,D,1942,1943
Steve Gotaas,49,6,9,15,0.306,53,C,1987,1991
Kyle Wanvig,75,6,9,15,0.2,94,RW,2002,2008
Greg Hubick,77,6,9,15,0.195,10,D,1975,1980
Johan Davidsson,83,6,9,15,0.18100000000000002,16,C,1998,2000
Kaspars Daugavins,91,6,9,15,0.165,21,W/C,2009,2013
Gino Rozzini,31,5,10,15,0.484,20,C,1944,1945
Christian Wolanin,44,5,10,15,0.341,6,D,2017,2021
Pat McReavy,55,5,10,15,0.273,4,C,1938,1942
Mathias Johansson,58,5,10,15,0.259,16,C,2002,2003
Nathan Oystrick,65,5,10,15,0.231,61,D,2008,2011
Harry Taylor,66,5,10,15,0.22699999999999998,30,C,1946,1952
Oliver Kylington,87,5,10,15,0.172,26,D,2015,2021
John Doran,98,5,10,15,0.153,110,D,1933,1940
John MacMillan,104,5,10,15,0.14400000000000002,32,RW,1960,1965
Kevin Morrison,41,4,11,15,0.366,23,LW/D,1979,1980
Antti Suomela,47,4,11,15,0.319,8,C,2018,2020
Cully Simon,130,4,11,15,0.115,121,D,1942,1945
Mike McKee,48,3,12,15,0.313,41,LW/D,1993,1994
Dryden Hunt,63,3,12,15,0.23800000000000002,34,LW/C,2017,2021
Mark Fusco,80,3,12,15,0.188,42,D,1983,1985
Ladislav Benysek,161,3,12,15,0.09300000000000001,74,D,1997,2003
Howard Walker,83,2,13,15,0.18100000000000002,133,D,1980,1983
Barry Salovaara,90,2,13,15,0.16699999999999998,70,D,1974,1976
Jerome Engele,100,2,13,15,0.15,162,D,1975,1978
Brian Lashoff,136,2,13,15,0.11,65,D,2012,2020
Rick Berry,197,2,13,15,0.076,314,D,2000,2004
Dean Kukan,82,1,14,15,0.183,20,D,2015,2021
Willie Brossart,129,1,14,15,0.11599999999999999,88,D,1970,1976
Steven Halko,155,0,15,15,0.09699999999999999,71,D,1997,2003
Joe Krol,26,10,4,14,0.5379999999999999,8,LW,1936,1942
Nelson Debenedet,46,10,4,14,0.304,13,LW,1973,1975
Yuri Butsayev,99,10,4,14,0.141,28,RW,1999,2003
Veli-Pekka Ketola,44,9,5,14,0.318,4,C,1981,1982
Jani Rita,66,9,5,14,0.212,10,LW/RW,2001,2006
Archie Briden,71,9,5,14,0.19699999999999998,56,LW,1926,1930
Mike Needham,86,9,5,14,0.163,16,RW,1991,1994
Mike Danton,87,9,5,14,0.161,182,C,2000,2004
Jan Caloun,24,8,6,14,0.583,2,RW,1995,2001
Grigorijs Pantelejevs,54,8,6,14,0.259,12,LW,1992,1996
Jacques Cossette,64,8,6,14,0.21899999999999997,29,RW,1975,1979
Wilfie Starr,87,8,6,14,0.161,25,LW,1932,1936
Samuel Rothschild,100,8,6,14,0.14,25,LW,1924,1928
Clem Loughlin,101,8,6,14,0.139,77,D,1926,1929
C.J. Young,43,7,7,14,0.326,32,RW,1992,1993
Robert Dome,53,7,7,14,0.264,12,RW,1997,2003
Ron Friest,64,7,7,14,0.21899999999999997,191,LW,1980,1983
Ross Johnston,78,7,7,14,0.179,183,LW,2015,2021
Mario Roberge,112,7,7,14,0.125,314,LW,1990,1995
Barry E. Smith,114,7,7,14,0.12300000000000001,10,C,1975,1981
Cody Glass,42,6,8,14,0.33299999999999996,6,C,2019,2021
Chris Nielsen,52,6,8,14,0.26899999999999996,8,RW,2000,2002
Nikita Filatov,53,6,8,14,0.264,20,LW/RW,2008,2012
Darren Archibald,55,6,8,14,0.255,26,RW/LW,2013,2019
Tim Hrynewich,55,6,8,14,0.255,82,LW,1982,1984
Kevin Smyth,58,6,8,14,0.24100000000000002,31,RW,1993,1996
Albert Hughes,60,6,8,14,0.233,22,C,1930,1932
Link Gaetz,65,6,8,14,0.215,412,D,1988,1992
Dante Fabbro,72,6,8,14,0.19399999999999998,38,D,2018,2021
Ross Lowe,77,6,8,14,0.182,82,LW,1949,1952
Dave Cressman,85,6,8,14,0.165,37,LW,1974,1976
Gizzy Hart,104,6,8,14,0.135,12,LW,1926,1933
Cam Janssen,336,6,8,14,0.042,774,RW,2005,2014
Jeff Shevalier,32,5,9,14,0.43799999999999994,8,LW,1994,2000
Ken Kuzyk,41,5,9,14,0.341,8,RW,1976,1978
Tod Campeau,42,5,9,14,0.33299999999999996,16,C,1943,1949
Russ Brayshaw,43,5,9,14,0.326,24,LW,1944,1945
Josh Holden,60,5,9,14,0.233,16,C,1998,2004
Eric Landry,68,5,9,14,0.20600000000000002,47,C,1997,2002
Andreas Salomonsson,71,5,9,14,0.19699999999999998,36,LW,2001,2003
Dominic Toninato,85,5,9,14,0.165,49,C,2017,2021
Jason Botterill,88,5,9,14,0.159,89,LW,1997,2004
Ryan Hollweg,228,5,9,14,0.061,349,LW,2005,2011
Al Murray,271,5,9,14,0.052000000000000005,163,D,1933,1940
Mark Botell,32,4,10,14,0.43799999999999994,31,D,1981,1982
Nikolai Prokhorkin,43,4,10,14,0.326,6,C,2019,2020
Willie O'Ree,45,4,10,14,0.311,26,RW,1957,1961
Geoff Platt,46,4,10,14,0.304,28,W/C,2005,2008
Dusan Pasek,48,4,10,14,0.292,30,C,1988,1989
Brendan Guhle,59,4,10,14,0.237,24,D,2016,2021
Jim Wiley,62,4,10,14,0.226,8,C,1972,1977
Jakub Klepis,66,4,10,14,0.212,36,C/RW,2005,2007
Sergei Gusev,89,4,10,14,0.157,34,D,1997,2001
Kurtis MacDermid,92,4,10,14,0.152,115,D,2017,2021
Craig Weller,95,4,10,14,0.147,127,RW/D,2007,2009
Bert Robertsson,123,4,10,14,0.114,61,D,1997,2001
Anthony Peluso,148,4,10,14,0.095,220,RW,2012,2019
Keith Aulie,167,4,10,14,0.084,196,D,2010,2015
Taro Hirose,36,3,11,14,0.389,8,LW/RW,2018,2021
Matt Ellison,43,3,11,14,0.326,19,C/W,2003,2007
Kerby Rychel,43,3,11,14,0.326,19,LW,2014,2019
Martin Hostak,55,3,11,14,0.255,24,RW,1990,1992
Anders Eldebrink,55,3,11,14,0.255,29,D,1981,1983
Aaron Palushaj,68,3,11,14,0.20600000000000002,18,RW/LW,2010,2014
Mark Osiecki,93,3,11,14,0.151,43,D,1991,1993
Ian Cushenan,129,3,11,14,0.109,134,D,1956,1964
Marc-Andre Cliche,151,3,11,14,0.09300000000000001,34,C,2009,2015
Jim Leavins,41,2,12,14,0.341,30,D,1985,1987
Vladimir Zharkov,82,2,12,14,0.171,10,RW/LW,2009,2012
Tim Erixon,93,2,12,14,0.151,38,D,2011,2015
Aris Brimanis,113,2,12,14,0.124,57,D,1993,2004
Richard Zemlak,132,2,12,14,0.106,587,RW,1986,1992
Sven Butenschon,140,2,12,14,0.1,86,D,1997,2006
Jamie Masters,33,1,13,14,0.424,2,D,1975,1979
Dylan Sikura,47,1,13,14,0.298,0,W/C,2017,2020
Ken Breitenbach,68,1,13,14,0.20600000000000002,49,D,1975,1979
Ryan Lindgren,69,1,13,14,0.203,57,D,2018,2021
Joe Zanussi,87,1,13,14,0.161,46,D,1974,1977
Magnus Johansson,45,0,14,14,0.311,18,D,2007,2008
Stan McCabe,78,9,4,13,0.16699999999999998,49,LW,1929,1934
Don MacLean,41,8,5,13,0.317,6,LW,1997,2007
Joey Anderson,52,8,5,13,0.25,8,RW,2018,2021
Lloyd Andrews,53,8,5,13,0.245,10,LW,1921,1925
Blake Geoffrion,55,8,5,13,0.23600000000000002,34,C/LW,2010,2012
Colin Stuart,56,8,5,13,0.23199999999999998,26,C/LW,2007,2012
Jim O'Brien,77,8,5,13,0.16899999999999998,16,C/RW,2010,2018
Don Webster,27,7,6,13,0.48100000000000004,28,LW,1943,1944
Mike Glumac,40,7,6,13,0.325,38,C/RW,2005,2008
Tomas Jelinek,49,7,6,13,0.265,52,RW,1992,1993
Patrik Juhlin,56,7,6,13,0.23199999999999998,23,RW,1994,1996
Bob Beckett,68,7,6,13,0.191,18,C,1956,1964
Les Colwill,69,7,6,13,0.188,16,RW,1958,1959
Harry Zolnierczyk,84,7,6,13,0.155,93,LW/RW,2011,2017
Serge Payer,124,7,6,13,0.105,49,C,2000,2007
Mike Blunden,127,7,6,13,0.102,145,RW,2006,2018
Jack Schmidt,45,6,7,13,0.289,6,LW,1942,1943
Lyle Phair,48,6,7,13,0.271,12,LW,1985,1988
Simon Gamache,48,6,7,13,0.271,18,LW/C,2002,2008
David Ullstrom,49,6,7,13,0.265,12,C/W,2011,2013
Teemu Hartikainen,52,6,7,13,0.25,16,C/W,2010,2013
Sam Lafferty,53,6,7,13,0.245,23,C/LW,2019,2021
Matt Foy,56,6,7,13,0.23199999999999998,48,RW,2005,2008
Kiefer Sherwood,60,6,7,13,0.217,14,W/C,2018,2021
Jiri Bicek,62,6,7,13,0.21,29,LW/RW,2000,2004
Mario Kempe,70,6,7,13,0.18600000000000003,22,C/W,2017,2019
Bill Meronek,19,5,8,13,0.684,0,C,1939,1943
Dominic Lavoie,38,5,8,13,0.342,32,D,1988,1994
T.J. Brennan,53,5,8,13,0.245,29,D,2011,2016
Brett Seney,53,5,8,13,0.245,31,LW/C,2018,2020
Jarmo Kekalainen,55,5,8,13,0.23600000000000002,28,LW,1989,1994
Yohann Auvitu,58,5,8,13,0.22399999999999998,10,D,2016,2018
Riku Hahl,92,5,8,13,0.141,38,C,2001,2004
Christoffer Ehn,114,5,8,13,0.114,8,C/LW,2018,2020
Frank Simonetti,115,5,8,13,0.113,76,D,1984,1988
Jay Caufield,208,5,8,13,0.063,759,RW,1986,1993
Gordon Bruce,28,4,9,13,0.46399999999999997,13,LW,1940,1946
Kyle Wilson,39,4,9,13,0.33299999999999996,12,C,2009,2012
Guy Labrie,42,4,9,13,0.31,16,D,1943,1945
Yevgeni Medvedev,45,4,9,13,0.289,34,D,2015,2016
Gus Forslund,48,4,9,13,0.271,2,RW,1932,1933
Clare Raglan,100,4,9,13,0.13,52,D,1950,1953
Tim Wallace,101,4,9,13,0.129,45,C/RW,2008,2013
Jordan Hendry,131,4,9,13,0.099,40,D,2007,2013
Jack Gordon,36,3,10,13,0.361,0,C,1948,1951
Mark Mancari,42,3,10,13,0.31,22,RW/LW,2006,2012
Petr Prajsler,46,3,10,13,0.28300000000000003,51,D,1987,1992
Don McSween,47,3,10,13,0.27699999999999997,55,D,1987,1996
Vladislav Kamenev,66,3,10,13,0.19699999999999998,20,C/W,2016,2020
Jim McTaggart,71,3,10,13,0.183,205,D,1980,1982
Gord Mark,85,3,10,13,0.153,187,D,1986,1995
Zach Trotman,91,3,10,13,0.14300000000000002,30,D,2013,2020
Mark Ferner,91,3,10,13,0.14300000000000002,51,D,1986,1995
Jeff Giuliano,101,3,10,13,0.129,40,LW,2005,2008
Kevin Kaminski,139,3,10,13,0.094,528,C,1988,1997
David Van Der Gulik,49,2,11,13,0.265,10,LW/RW,2008,2015
Jim Ross,62,2,11,13,0.21,29,D,1951,1953
Mario Ferraro,66,2,11,13,0.19699999999999998,32,D,2019,2021
Mathieu Roy,66,2,11,13,0.19699999999999998,76,D,2005,2013
Andy Schliebener,84,2,11,13,0.155,74,D,1981,1985
Julius Honka,87,2,11,13,0.149,28,D,2016,2021
Brett Carson,90,2,11,13,0.14400000000000002,20,D,2008,2013
Jonas Siegenthaler,91,2,11,13,0.14300000000000002,53,D,2018,2021
Jarno Kultanen,102,2,11,13,0.127,59,D,2000,2003
Luke Witkowski,131,2,11,13,0.099,162,D/RW,2014,2020
Bryan Rodney,34,1,12,13,0.382,12,D,2008,2012
Chris Felix,35,1,12,13,0.371,10,D,1987,1991
Christian Jaros,76,1,12,13,0.171,33,D,2017,2020
Kevin Gravel,109,1,12,13,0.11900000000000001,12,D,2015,2020
Ray Giroux,38,0,13,13,0.342,22,D,1999,2004
George Horne,54,9,3,12,0.222,34,RW,1925,1929
Hago Harrington,72,9,3,12,0.16699999999999998,15,LW,1925,1933
Robert Ritchie,29,8,4,12,0.414,10,LW,1976,1978
Jerry Holland,37,8,4,12,0.324,6,LW,1974,1976
Tom McMurchy,55,8,4,12,0.218,65,RW,1983,1988
Leo Gaudreault,67,8,4,12,0.179,30,LW,1927,1933
Stuart Kulak,70,8,4,12,0.171,130,RW,1982,1989
Trevor Stienburg,71,8,4,12,0.16899999999999998,166,RW,1985,1989
Vern Kaiser,50,7,5,12,0.24,33,LW,1950,1951
Rob Whistle,51,7,5,12,0.235,16,D,1985,1988
Eric Robinson,69,7,5,12,0.174,12,LW/RW,2017,2021
Landon Ferraro,77,7,5,12,0.156,29,C/RW,2013,2018
Chuck Scherza,36,6,6,12,0.33299999999999996,35,C,1943,1945
Alexandre Giroux,48,6,6,12,0.25,26,LW/RW,2005,2012
Jonny Brodzinski,57,6,6,12,0.21100000000000002,10,RW/C,2016,2020
Terry Clancy,93,6,6,12,0.129,39,RW,1967,1973
Reginald Savage,34,5,7,12,0.353,28,RW,1990,1994
Kim Davis,36,5,7,12,0.33299999999999996,51,C,1977,1981
Serge Boisvert,46,5,7,12,0.261,8,C,1982,1988
Matt Davidson,56,5,7,12,0.214,28,RW,2000,2003
Orval Tessier,59,5,7,12,0.203,6,C,1954,1961
Steve Moore,69,5,7,12,0.174,37,C,2001,2004
David Latta,36,4,8,12,0.33299999999999996,4,LW,1985,1991
Bill Masterton,38,4,8,12,0.316,4,C,1967,1968
Ronalds Kenins,38,4,8,12,0.316,14,LW/RW,2014,2016
Bobby Kirk,39,4,8,12,0.308,14,RW,1937,1938
Aud Tuten,39,4,8,12,0.308,48,D,1941,1943
Brian Wilks,46,4,8,12,0.261,25,C,1984,1987
Steve Wagner,46,4,8,12,0.261,26,D,2007,2009
Corban Knight,52,4,8,12,0.231,4,C,2013,2019
Matt Taormina,59,4,8,12,0.203,6,D,2010,2016
Paul Nicholson,62,4,8,12,0.19399999999999998,18,LW,1974,1977
Tyler Bouck,91,4,8,12,0.132,93,LW,2000,2007
Larry Wright,106,4,8,12,0.113,19,C,1971,1978
Darcy Loewen,135,4,8,12,0.08900000000000001,211,LW,1989,1994
James Wright,146,4,8,12,0.08199999999999999,64,C/LW,2009,2014
Ole-Kristian Tollefsen,163,4,8,12,0.07400000000000001,296,D,2005,2010
Dan Kordic,197,4,8,12,0.061,584,D/LW,1991,1999
Jukka Porvari,39,3,9,12,0.308,4,RW,1981,1983
Bob Copp,40,3,9,12,0.3,26,D,1942,1951
Alex McKendry,46,3,9,12,0.261,21,LW,1977,1981
Gord Hynes,52,3,9,12,0.231,22,D,1991,1993
Dennis Everberg,70,3,9,12,0.171,10,RW/LW,2014,2016
Larry Bolonchuk,74,3,9,12,0.162,97,D,1972,1978
Juuso Riikola,75,3,9,12,0.16,16,D,2018,2021
Todd Charlesworth,93,3,9,12,0.129,47,D,1983,1990
Jack Bionda,93,3,9,12,0.129,113,D,1955,1959
Ryan Sproul,44,2,10,12,0.273,12,D,2013,2018
Joe McDonnell,50,2,10,12,0.24,34,C,1981,1986
Keith Cory,51,2,10,12,0.235,41,D,1979,1981
Mikhail Yakubov,53,2,10,12,0.226,20,C,2003,2006
Dmitri Bykov,71,2,10,12,0.16899999999999998,43,D,2002,2003
Stuart Smith,77,2,10,12,0.156,95,D,1979,1983
Andy Wozniewski,79,2,10,12,0.152,81,D,2005,2010
Nick Seeler,105,2,10,12,0.114,100,D,2017,2020
Manny Viveiros,29,1,11,12,0.414,6,D,1985,1988
Nicolas Hague,40,1,11,12,0.3,32,D,2019,2021
Mike Forbes,50,1,11,12,0.24,41,D,1977,1982
Virgil Johnson,75,1,11,12,0.16,27,D,1937,1945
Barry Legge,107,1,11,12,0.11199999999999999,144,D,1979,1982
Radim Bicanek,122,1,11,12,0.098,62,D,1994,2002
Jeremy Williams,32,9,2,11,0.344,6,RW,2005,2011
Frank Banham,32,9,2,11,0.344,16,RW,1996,2003
Tyler Graovac,70,9,2,11,0.157,14,C,2014,2020
Aldo Palazzari,35,8,3,11,0.314,4,RW,1943,1944
Morley Bruce,71,8,3,11,0.155,27,D,1917,1922
Maxim Sushinsky,30,7,4,11,0.36700000000000005,29,RW,2000,2001
Stephane Da Costa,47,7,4,11,0.23399999999999999,10,C/RW,2010,2014
Lukas Radil,50,7,4,11,0.22,14,LW/RW,2018,2020
Florent Robidoux,52,7,4,11,0.212,75,LW,1980,1984
Mark Kachowski,64,6,5,11,0.172,209,LW,1987,1990
Barry Potomski,68,6,5,11,0.162,227,LW,1995,1998
Harold Starr,205,6,5,11,0.054000000000000006,186,D,1929,1936
Scott Barney,27,5,6,11,0.40700000000000003,4,C/RW,2002,2006
Fernand Leblanc,34,5,6,11,0.324,0,LW,1976,1979
David Emma,34,5,6,11,0.324,2,RW,1992,2001
Dennis Sobchuk,35,5,6,11,0.314,2,C,1979,1983
Peter Cehlarik,40,5,6,11,0.275,10,LW/RW,2016,2020
Nicolas Roy,40,5,6,11,0.275,14,C/RW,2017,2021
Mike Dark,43,5,6,11,0.256,14,D,1986,1988
Corey Foster,45,5,6,11,0.244,24,D,1988,1997
Marc Boileau,54,5,6,11,0.204,8,C,1961,1962
Filip Chlapik,56,5,6,11,0.196,18,C,2017,2021
Dylan Gambrell,63,5,6,11,0.175,21,C/RW,2017,2021
Mike Neville,67,5,6,11,0.16399999999999998,14,C,1924,1931
Bruce Cowick,70,5,6,11,0.157,43,F,1973,1976
John Scott,286,5,6,11,0.038,544,LW,2008,2016
Daniel Tkaczuk,19,4,7,11,0.579,14,C,2000,2001
Ian Kidd,20,4,7,11,0.55,25,D,1987,1989
Ralph Wycherley,28,4,7,11,0.39299999999999996,6,LW,1940,1942
Bill Bennett,31,4,7,11,0.355,65,RW,1978,1980
Karson Kuhlman,36,4,7,11,0.306,15,C/RW,2018,2021
Jason Jaffray,49,4,7,11,0.22399999999999998,40,LW/C,2007,2012
Max Quackenbush,61,4,7,11,0.18,30,D,1950,1952
Frazer McLaren,102,4,7,11,0.10800000000000001,264,LW,2009,2014
D.J. King,118,4,7,11,0.09300000000000001,215,LW/RW,2006,2012
Hamby Shore,18,3,8,11,0.611,51,D,1917,1918
John Lilley,23,3,8,11,0.478,13,RW,1993,1996
Viktor Gordiyuk,26,3,8,11,0.423,0,C/RW,1992,1995
Steve Witiuk,33,3,8,11,0.33299999999999996,14,RW,1951,1952
Sergei Pryakhin,46,3,8,11,0.239,2,RW,1988,1991
Andreas Borgman,48,3,8,11,0.22899999999999998,28,D,2017,2021
Jeff Nelson,52,3,8,11,0.212,20,C,1994,1999
Eric Beaudoin,53,3,8,11,0.20800000000000002,41,LW/C,2001,2004
Esa Pirnes,57,3,8,11,0.193,12,C,2003,2004
Peter Driscoll,60,3,8,11,0.183,97,RW,1979,1981
Adam Bennett,69,3,8,11,0.159,69,D,1991,1994
Quintin Laing,79,3,8,11,0.139,31,LW,2003,2010
Nikita Tryamkin,79,3,8,11,0.139,74,D,2015,2017
Jack Bownass,80,3,8,11,0.138,58,D,1957,1962
Brad Norton,124,3,8,11,0.08900000000000001,287,D,2001,2008
J.T. Wyman,44,2,9,11,0.25,8,RW/D,2009,2013
Larry Hornung,48,2,9,11,0.22899999999999998,10,D,1970,1972
David Warsofsky,55,2,9,11,0.2,8,D,2013,2018
Jeff Hoggan,107,2,9,11,0.10300000000000001,76,RW/LW,2005,2010
Alex Henry,177,2,9,11,0.062,269,D,2002,2009
Jim Wiste,52,1,10,11,0.212,8,C,1968,1971
Joe Day,72,1,10,11,0.153,87,C,1991,1994
Jarred Tinordi,81,1,10,11,0.136,112,D,2012,2021
Matt Jones,106,1,10,11,0.10400000000000001,63,D,2005,2008
Ken Murray,106,1,10,11,0.10400000000000001,135,D,1969,1976
Brent Thompson,121,1,10,11,0.091,352,D,1991,1997
Gustav Olofsson,59,0,11,11,0.18600000000000003,18,D,2015,2020
Stan Brown,48,8,2,10,0.20800000000000002,18,D,1926,1928
Bobby Farnham,67,8,2,10,0.149,138,RW/LW,2014,2017
Garth Murray,116,8,2,10,0.086,131,LW,2003,2009
Stephen Peat,130,8,2,10,0.077,234,RW,2001,2006
Jesse Boulerice,172,8,2,10,0.057999999999999996,333,RW,2001,2009
Tony Bukovich,17,7,3,10,0.588,6,LW,1943,1945
Doug Morrison,23,7,3,10,0.435,15,RW,1979,1985
Yves Preston,28,7,3,10,0.35700000000000004,4,LW,1978,1981
Errol Rausse,31,7,3,10,0.32299999999999995,0,D/LW,1979,1982
Nick Baptiste,47,7,3,10,0.213,20,RW,2016,2018
Bill Miller,95,7,3,10,0.105,16,F,1934,1937
Christopher DiDomenico,27,6,4,10,0.37,14,C/RW,2016,2018
Don Deacon,30,6,4,10,0.33299999999999996,6,LW,1936,1940
Kevin Stenlund,36,6,4,10,0.278,12,C/RW,2018,2021
Rocky Trottier,38,6,4,10,0.263,2,F,1983,1985
Greg Meredith,38,6,4,10,0.263,8,RW,1980,1983
Peter Sejna,48,6,4,10,0.20800000000000002,12,LW,2002,2007
Bill Holmes,52,6,4,10,0.192,35,C,1925,1930
Art Giroux,54,6,4,10,0.185,14,RW,1932,1936
Scott Thomas,63,6,4,10,0.159,32,RW,1992,2001
Allan Stewart,64,6,4,10,0.156,243,LW,1985,1992
Max McCormick,71,6,4,10,0.141,78,LW/RW,2015,2021
Jim Hrycuik,21,5,5,10,0.47600000000000003,12,C,1974,1975
Jean-Francois Quintin,22,5,5,10,0.455,4,LW,1991,1993
Neal Coulter,26,5,5,10,0.385,11,RW,1985,1988
Bill McDougall,28,5,5,10,0.35700000000000004,12,RW,1990,1994
Carl Grundstrom,30,5,5,10,0.33299999999999996,14,LW/RW,2018,2021
Eric Wellwood,31,5,5,10,0.32299999999999995,4,LW/C,2010,2013
John Keating,35,5,5,10,0.28600000000000003,17,LW,1931,1933
Greg Mauldin,36,5,5,10,0.278,12,C/W,2003,2011
Tommy Lehmann,36,5,5,10,0.278,16,C,1987,1990
Nels Crutchfield,41,5,5,10,0.244,20,C,1934,1935
Tom Songin,43,5,5,10,0.233,22,RW,1978,1981
Johnny Harms,44,5,5,10,0.22699999999999998,21,RW,1943,1945
Jean-Paul Lamirande,49,5,5,10,0.204,26,D,1946,1955
Louis Leblanc,50,5,5,10,0.2,32,C/RW,2011,2014
Gaetan Haas,58,5,5,10,0.172,6,C,2019,2021
Stefan Matteau,73,5,5,10,0.13699999999999998,32,C/LW,2012,2021
Eddie Bush,26,4,6,10,0.385,40,D,1938,1942
Patrick Fischer,27,4,6,10,0.37,24,LW,2006,2007
Zdenek Nedved,31,4,6,10,0.32299999999999995,14,RW,1994,1997
Gary Edmundson,43,4,6,10,0.233,49,D,1951,1961
Chris Govedaris,45,4,6,10,0.222,24,LW,1989,1994
Jack Price,57,4,6,10,0.175,24,D,1951,1954
Joseph Cramarossa,59,4,6,10,0.16899999999999998,60,C/LW,2016,2017
Kris Newbury,75,4,6,10,0.133,139,C/LW,2006,2014
Micah Aivazoff,92,4,6,10,0.109,46,C,1993,1996
Josh Brown,97,4,6,10,0.10300000000000001,71,D,2018,2021
Al Rittinger,19,3,7,10,0.526,0,RW,1943,1944
David Cooper,30,3,7,10,0.33299999999999996,24,D,1996,2001
Rick Vasko,31,3,7,10,0.32299999999999995,29,D,1977,1981
Colin Blackwell,33,3,7,10,0.303,12,C,2018,2021
Andy Berenzweig,37,3,7,10,0.27,14,D,1999,2003
Perry Ganchar,42,3,7,10,0.23800000000000002,36,RW,1983,1989
Graeme Townshend,45,3,7,10,0.222,28,RW,1989,1994
Ron Meighan,48,3,7,10,0.20800000000000002,18,D,1981,1983
Chris Mueller,53,3,7,10,0.18899999999999997,8,C/RW,2010,2015
Bruno St-Jacques,67,3,7,10,0.149,47,D,2001,2006
Richie Hansen,20,2,8,10,0.5,4,C,1976,1982
John Baby,26,2,8,10,0.385,26,D,1977,1979
Mike Sgarbossa,50,2,8,10,0.2,23,C,2012,2020
Sami Niku,51,2,8,10,0.196,20,D,2017,2021
Joe Lundrigan,52,2,8,10,0.192,22,D,1972,1975
Brett Sutter,60,2,8,10,0.16699999999999998,40,LW/C,2008,2015
Clayton Beddoes,60,2,8,10,0.16699999999999998,57,C,1995,1997
Dmitri Tertyshny,62,2,8,10,0.161,30,D,1998,1999
Rick Jodzio,70,2,8,10,0.14300000000000002,71,LW,1977,1978
Ken Sabourin,74,2,8,10,0.135,201,D,1988,1992
Billy Tibbetts,82,2,8,10,0.122,269,RW,2000,2003
Maxim Kuznetsov,136,2,8,10,0.07400000000000001,137,D,2000,2004
Tomas Kloucek,141,2,8,10,0.071,250,D,2000,2006
Noah Dobson,38,1,9,10,0.263,10,D,2019,2021
Nolan Yonkman,76,1,9,10,0.132,140,D,2001,2014
John Arbour,106,1,9,10,0.094,149,D,1965,1972
Brendan Mikkelson,131,1,9,10,0.076,59,D,2008,2013
Len Esau,27,0,10,10,0.37,24,D,1991,1995
Tim Jacobs,46,0,10,10,0.217,35,D,1975,1976
Viktor Antipin,47,0,10,10,0.213,18,D,2017,2018
Marko Kiprusoff,51,0,10,10,0.196,12,D,1995,2002
John Stevens,53,0,10,10,0.18899999999999997,48,D,1986,1994
Carl Dahlstrom,64,0,10,10,0.156,12,D,2017,2020
Stu Bickel,76,0,10,10,0.132,203,D/RW,2011,2015
Hal Hicks,96,7,2,9,0.094,72,D,1928,1931
Albert Holway,112,7,2,9,0.08,48,D,1923,1929
Fred Knipscheer,28,6,3,9,0.321,18,C,1993,1996
Laurie Scott,62,6,3,9,0.145,28,F,1926,1928
Earl Campbell,76,6,3,9,0.11800000000000001,14,D,1923,1926
Wade Brookbank,127,6,3,9,0.071,345,D/LW,2003,2009
Gabriel Vilardi,14,5,4,9,0.643,6,C,2019,2021
Frank Ashworth,18,5,4,9,0.5,2,C,1946,1947
Harvey Fraser,21,5,4,9,0.429,0,C,1944,1945
Mark Marquess,27,5,4,9,0.33299999999999996,6,RW,1946,1947
Brett Sterling,30,5,4,9,0.3,32,LW/RW,2007,2012
Gerry Ouellette,34,5,4,9,0.265,0,RW,1960,1961
Steve Graves,35,5,4,9,0.257,10,LW,1983,1988
Craig Duncanson,38,5,4,9,0.237,61,LW,1985,1993
Ross Johnstone,42,5,4,9,0.214,14,D,1943,1945
Chapman Kitchen,47,5,4,9,0.191,58,D,1925,1927
Frantisek Cernik,49,5,4,9,0.184,13,RW,1984,1985
Bud Cook,50,5,4,9,0.18,22,C,1931,1935
Richard Nantais,63,5,4,9,0.14300000000000002,79,LW,1974,1977
Justin Bailey,65,5,4,9,0.138,10,RW,2015,2021
Lee Goren,67,5,4,9,0.134,44,RW,2000,2007
Gerry Brown,23,4,5,9,0.391,2,LW,1941,1946
Sylvain Couturier,33,4,5,9,0.273,4,C,1988,1992
Christoph Brandner,35,4,5,9,0.257,8,LW,2003,2004
Pete Backor,36,4,5,9,0.25,6,D,1944,1945
Jukka Hentunen,38,4,5,9,0.237,4,RW,2001,2002
Hannes Hyvonen,42,4,5,9,0.214,22,RW,2001,2003
Mattias Ritola,43,4,5,9,0.209,17,LW/RW,2007,2012
Dmytro Timashov,44,4,5,9,0.205,16,LW/RW,2019,2021
Tim Coulis,47,4,5,9,0.191,138,LW,1979,1986
Matt Herr,58,4,5,9,0.155,25,C,1998,2003
Colby Cave,67,4,5,9,0.134,22,C,2017,2020
Kurt Walker,71,4,5,9,0.127,142,RW,1975,1978
Noah Welch,75,4,5,9,0.12,58,D,2005,2011
Pierre Sevigny,78,4,5,9,0.115,64,LW,1993,1998
Jason Holland,81,4,5,9,0.111,36,D,1996,2004
Red Mitchell,83,4,5,9,0.10800000000000001,67,D,1941,1945
Gus Rivers,88,4,5,9,0.102,12,RW,1929,1932
Nathan Perrott,89,4,5,9,0.10099999999999999,251,RW,2001,2006
Gabriel Dumont,90,4,5,9,0.1,48,C/RW,2011,2020
Phil Crowe,94,4,5,9,0.096,173,LW,1993,2000
Sandy Fitzpatrick,22,3,6,9,0.409,8,C,1964,1968
Glen Richardson,24,3,6,9,0.375,19,LW,1975,1976
Helmuts Balderis,26,3,6,9,0.34600000000000003,2,RW,1989,1990
Joseph Godin,27,3,6,9,0.33299999999999996,12,RW,1977,1979
Jakob Forsbacka Karlsson,29,3,6,9,0.31,2,C,2016,2019
Luca Caputi,35,3,6,9,0.257,20,LW,2008,2011
Joakim Nygard,36,3,6,9,0.25,10,LW,2019,2021
Cameron Gaunce,37,3,6,9,0.243,47,D,2010,2020
Justin Mapletoft,38,3,6,9,0.237,8,C,2002,2004
Christian Hanson,42,3,6,9,0.214,22,C/RW,2008,2011
Terry Holbrook,43,3,6,9,0.209,4,F,1972,1974
Mark Wotton,43,3,6,9,0.209,25,D,1994,2001
Jeff Bloemberg,43,3,6,9,0.209,25,D,1988,1992
Ed Hatoum,47,3,6,9,0.191,25,RW,1968,1971
Justin Dowling,49,3,6,9,0.184,10,C/W,2016,2020
Gordon Davidson,51,3,6,9,0.17600000000000002,8,D,1942,1944
Travis Brigley,55,3,6,9,0.16399999999999998,16,LW,1997,2004
Jim Shires,56,3,6,9,0.161,32,LW,1970,1973
Jeff Greenlaw,57,3,6,9,0.158,108,LW,1986,1994
Ben Street,59,3,6,9,0.153,10,C/LW,2012,2020
Claude Houde,59,3,6,9,0.153,40,D,1974,1976
Lias Andersson,68,3,6,9,0.132,33,C/LW,2017,2021
Don Willson,22,2,7,9,0.409,0,C,1937,1939
Spencer Machacek,25,2,7,9,0.36,7,RW,2008,2012
Josh Mahura,28,2,7,9,0.321,6,D,2018,2020
Tony Stiles,30,2,7,9,0.3,20,D,1983,1984
Bob Dawes,32,2,7,9,0.281,6,D,1946,1951
Pavel Patera,32,2,7,9,0.281,8,C,1999,2001
Chris Snell,34,2,7,9,0.265,24,D,1993,1995
John Tripp,43,2,7,9,0.209,35,RW,2002,2004
Jerome Samson,46,2,7,9,0.196,18,RW/C,2009,2012
Lawrence Nycholat,50,2,7,9,0.18,24,D,2003,2009
Gary Gambucci,51,2,7,9,0.17600000000000002,9,C,1971,1974
Graeme Nicolson,52,2,7,9,0.17300000000000001,60,D,1978,1983
Matt Murley,62,2,7,9,0.145,38,C/W,2003,2008
Vladimir Chebaturkin,62,2,7,9,0.145,52,D,1997,2002
Tommi Santala,63,2,7,9,0.14300000000000002,46,C,2003,2007
Victor Oreskovich,67,2,7,9,0.134,41,RW,2009,2012
Chris Summers,70,2,7,9,0.129,51,D,2010,2016
Eric Charron,130,2,7,9,0.069,127,D,1992,2000
Tom Thornbury,14,1,8,9,0.643,16,D,1983,1984
Kyosti Karjalainen,28,1,8,9,0.321,12,RW,1991,1992
Logan Brown,29,1,8,9,0.31,4,C,2017,2020
Mike Hurlbut,29,1,8,9,0.31,20,D,1992,2000
Brad Schlegel,48,1,8,9,0.188,10,D,1991,1994
Guy Delparte,48,1,8,9,0.188,18,D,1976,1977
Oskars Bartulis,66,1,8,9,0.136,32,D,2009,2011
Fred Arthur,80,1,8,9,0.113,49,D,1980,1983
John Gruden,92,1,8,9,0.098,46,D,1993,2004
Yevgeni Namestnikov,43,0,9,9,0.209,24,D,1993,2000
Chris LiPuma,72,0,9,9,0.125,146,D,1992,1997
Dallas Eakins,120,0,9,9,0.075,208,D,1992,2002
Lude Check,27,6,2,8,0.29600000000000004,4,LW,1943,1945
Nikita Scherbak,37,6,2,8,0.21600000000000003,10,RW/LW,2016,2019
Drew Callander,39,6,2,8,0.205,7,C,1976,1980
Herb Mitchell,55,6,2,8,0.145,60,LW,1924,1926
Chuck Dinsmore,100,6,2,8,0.08,50,F,1924,1930
Brantt Myhres,154,6,2,8,0.052000000000000005,687,RW,1994,2003
Scott Howson,18,5,3,8,0.444,4,C,1984,1986
Dale Krentz,30,5,3,8,0.267,9,F,1986,1989
Buddy Boone,34,5,3,8,0.235,28,RW,1956,1958
Nick Lappin,60,5,3,8,0.133,21,RW,2016,2019
Jay Rosehill,117,5,3,8,0.068,352,LW,2009,2014
Luke Gazdic,147,5,3,8,0.054000000000000006,206,LW,2013,2017
Alain Langlais,25,4,4,8,0.32,10,RW,1973,1975
Kamil Piros,28,4,4,8,0.28600000000000003,10,C/W,2001,2004
Robert Tudor,28,4,4,8,0.28600000000000003,19,C,1978,1983
Richard David,31,4,4,8,0.258,10,LW,1979,1983
Saku Maenalanen,34,4,4,8,0.235,20,RW/LW,2018,2019
Clay Wilson,36,4,4,8,0.222,12,D,2007,2012
Pudge MacKenzie,36,4,4,8,0.222,13,RW,1932,1933
Brett Hauer,37,4,4,8,0.21600000000000003,38,D,1995,2002
Chris Durno,43,4,4,8,0.18600000000000003,47,LW,2008,2010
Pat Leahy,50,4,4,8,0.16,19,RW,2003,2007
Matthew Highmore,52,4,4,8,0.154,6,C/W,2017,2021
Joe Hulbig,55,4,4,8,0.145,16,LW,1996,2001
Bernie Brophy,62,4,4,8,0.129,25,LW,1925,1930
Bob Trapp,83,4,4,8,0.096,129,D,1926,1933
Dan Trebil,85,4,4,8,0.094,32,D,1996,2001
David Ling,93,4,4,8,0.086,191,RW/C,1996,2004
Warren Peters,96,4,4,8,0.083,72,C/LW,2008,2012
Roly Rossignol,14,3,5,8,0.5710000000000001,6,RW,1943,1946
Jarkko Immonen,20,3,5,8,0.4,4,C,2005,2007
Steve Stoyanovich,23,3,5,8,0.348,11,F,1983,1984
Brian Kilrea,26,3,5,8,0.308,12,C,1957,1968
Justin Kurtz,27,3,5,8,0.29600000000000004,14,D,2001,2002
Gene Achtymichuk,32,3,5,8,0.25,2,C,1951,1959
Mark Flood,39,3,5,8,0.205,10,D,2009,2012
Martin St. Pierre,39,3,5,8,0.205,12,C/LW,2005,2014
Magnus Roupe,40,3,5,8,0.2,42,LW,1987,1989
Eric O'Dell,41,3,5,8,0.195,29,C,2013,2015
Tanner Fritz,42,3,5,8,0.19,10,C/RW,2017,2019
Roger Belanger,44,3,5,8,0.182,32,C,1984,1985
Craig Cunningham,63,3,5,8,0.127,6,W/C,2013,2016
Frank Corrado,76,3,5,8,0.105,40,D,2012,2018
Frederick Gaudreau,84,3,5,8,0.095,4,C/RW,2016,2019
Marc Potvin,121,3,5,8,0.066,456,RW,1990,1996
Shawn Antoski,183,3,5,8,0.044000000000000004,599,LW,1990,1998
Dave Michayluk,14,2,6,8,0.5710000000000001,8,RW,1981,1992
Tomas Zizka,25,2,6,8,0.32,16,D,2002,2004
Mike Dwyer,31,2,6,8,0.258,25,LW,1978,1982
Jakub Jerabek,37,2,6,8,0.21600000000000003,8,D,2017,2019
Dan Seguin,37,2,6,8,0.21600000000000003,50,LW,1970,1974
George Pearson,38,2,6,8,0.21100000000000002,25,C,1959,1968
Barrie Moore,39,2,6,8,0.205,18,LW,1995,2000
Burke Henry,39,2,6,8,0.205,33,D,2002,2004
Andrew Agozzino,43,2,6,8,0.18600000000000003,4,LW/C,2014,2020
Noah Juulsen,44,2,6,8,0.182,10,D,2017,2021
Vinni Lettieri,46,2,6,8,0.174,14,C/RW,2017,2021
Brian Marchinko,47,2,6,8,0.17,0,C,1970,1974
Ben Maxwell,47,2,6,8,0.17,19,C/LW,2008,2012
Norm Locking,48,2,6,8,0.16699999999999998,26,LW,1934,1936
Rich Brennan,50,2,6,8,0.16,33,D,1996,2003
Chris Bourque,51,2,6,8,0.157,18,LW,2007,2013
Michael McCarron,69,2,6,8,0.11599999999999999,110,RW/C,2015,2021
Jason Bowen,77,2,6,8,0.10400000000000001,109,LW,1992,1998
Dan Focht,82,2,6,8,0.098,145,D,2001,2004
Garrett Wilson,84,2,6,8,0.095,42,LW/RW,2013,2019
Raymond Fortin,92,2,6,8,0.087,33,D,1967,1970
Ron Attwell,22,1,7,8,0.364,8,RW,1967,1968
Darren Haydar,23,1,7,8,0.348,2,RW,2002,2010
Rasmus Sandin,28,1,7,8,0.28600000000000003,10,D,2019,2021
Tom Hirsch,31,1,7,8,0.258,30,D,1983,1988
Dwight Mathiasen,33,1,7,8,0.242,18,RW,1985,1988
Jack Leswick,37,1,7,8,0.21600000000000003,16,C,1933,1934
Dean Kolstad,40,1,7,8,0.2,69,D,1988,1993
Yan Golubovsky,56,1,7,8,0.14300000000000002,32,D,1997,2001
Jim Hargreaves,66,1,7,8,0.121,105,D,1970,1973
Gaston Therrien,22,0,8,8,0.364,12,D,1980,1983
Bogdan Kiselevich,32,0,8,8,0.25,12,D,2018,2019
Joel Hanley,46,0,8,8,0.174,12,D,2015,2020
Brett Festerling,88,0,8,8,0.091,35,D,2008,2012
Ilya Lyubushkin,92,0,8,8,0.087,31,D,2018,2021
Tim Sestito,101,0,8,8,0.079,55,C/LW,2008,2015
Kim Clackson,106,0,8,8,0.075,370,D,1979,1981
Alex Gray,51,7,0,7,0.13699999999999998,32,RW,1927,1929
Kevin Roy,28,6,1,7,0.25,6,LW/RW,2017,2019
Robbie Earl,47,6,1,7,0.149,6,C/LW,2007,2011
Robin Bawa,61,6,1,7,0.115,60,RW,1989,1994
Alex Smart,8,5,2,7,0.875,0,LW,1942,1943
Ross Fitzpatrick,20,5,2,7,0.35,0,C,1982,1986
Zack MacEwen,24,5,2,7,0.292,25,RW,2018,2021
Jean-Sebastien Dea,32,5,2,7,0.21899999999999997,12,C/RW,2016,2020
Hec Lepine,33,5,2,7,0.212,2,F,1925,1926
Ron Hudson,33,5,2,7,0.212,2,C,1937,1940
Normand Shay,53,5,2,7,0.132,34,RW,1924,1926
Aaron Volpatti,114,5,2,7,0.061,137,LW/RW,2010,2015
Jean-Marc Gaulin,26,4,3,7,0.26899999999999996,8,RW,1982,1986
Ryan Stoa,40,4,3,7,0.175,20,C/LW,2009,2014
Marc-Andre Bourdon,45,4,3,7,0.156,52,D,2011,2012
Jordan Szwarz,50,4,3,7,0.14,25,RW/C,2013,2020
Ian McCoshen,60,4,3,7,0.11699999999999999,33,D,2016,2019
Roy Burmister,67,4,3,7,0.10400000000000001,2,LW,1929,1932
Sam Godin,83,4,3,7,0.084,36,RW,1927,1934
Jim Thomson,115,4,3,7,0.061,416,RW,1986,1994
Andrew Peters,229,4,3,7,0.031,650,LW,2003,2010
Jack Mann,9,3,4,7,0.778,0,F,1943,1945
Jarkko Varvio,13,3,4,7,0.5379999999999999,4,RW,1993,1995
Jaroslav Otevrel,16,3,4,7,0.43799999999999994,2,LW,1992,1994
Ron Plumb,26,3,4,7,0.26899999999999996,14,D,1979,1980
Tom Cassidy,26,3,4,7,0.26899999999999996,19,C,1977,1978
Mario Doyon,28,3,4,7,0.25,16,D,1988,1991
Gord Walker,31,3,4,7,0.226,23,RW,1986,1990
Joel Kellman,32,3,4,7,0.21899999999999997,6,C,2019,2021
Brandon Smith,33,3,4,7,0.212,10,D,1998,2003
Vic Howe,33,3,4,7,0.212,10,RW,1950,1955
Clark Donatelli,35,3,4,7,0.2,39,C,1989,1992
Garth Rizzuto,37,3,4,7,0.18899999999999997,16,C,1970,1971
Lucas Lessio,41,3,4,7,0.171,12,LW/RW,2013,2016
Jerry Byers,43,3,4,7,0.163,15,LW,1972,1978
Myles O'Connor,43,3,4,7,0.163,69,D,1990,1994
Igor Ozhiganov,53,3,4,7,0.132,14,D,2018,2019
Andrew Gordon,55,3,4,7,0.127,6,RW,2008,2013
Danny Syvret,59,3,4,7,0.11900000000000001,30,D,2005,2011
Michal Jordan,79,3,4,7,0.08900000000000001,18,D,2012,2016
Sylvain Blouin,115,3,4,7,0.061,336,LW,1996,2003
Claude Verret,14,2,5,7,0.5,2,C,1983,1985
Andrei Vasilyev,16,2,5,7,0.43799999999999994,6,C,1994,1999
Bob Wilkie,18,2,5,7,0.389,10,D,1990,1994
Warren Babe,21,2,5,7,0.33299999999999996,23,LW,1987,1991
Yves Courteau,22,2,5,7,0.318,4,RW,1984,1987
Morgan Frost,22,2,5,7,0.318,4,C,2019,2021
Jonas Bergqvist,22,2,5,7,0.318,10,RW,1989,1990
Yegor Yakovlev,25,2,5,7,0.28,6,D,2018,2019
Tomas Hyka,27,2,5,7,0.259,2,RW,2017,2019
Sergei Vyshedkevich,30,2,5,7,0.233,16,D,1999,2001
Rob Conn,30,2,5,7,0.233,20,RW,1991,1996
George Robertson,31,2,5,7,0.226,6,LW,1947,1949
Martin Prochazka,32,2,5,7,0.21899999999999997,8,RW,1997,2000
Jansen Harkins,32,2,5,7,0.21899999999999997,9,C,2019,2021
Peter Olvecky,32,2,5,7,0.21899999999999997,12,LW/C,2008,2010
Don Howse,33,2,5,7,0.212,6,LW,1979,1980
Bunny Dame,34,2,5,7,0.20600000000000002,4,LW,1941,1942
Alain Vigneault,42,2,5,7,0.16699999999999998,82,D,1981,1983
Fred Williams,44,2,5,7,0.159,10,C,1976,1977
Jason Morgan,44,2,5,7,0.159,18,C/LW,1996,2007
Daniel Laperriere,48,2,5,7,0.146,27,D,1992,1996
Jack Jackson,48,2,5,7,0.146,38,D,1946,1947
Brett Lindros,51,2,5,7,0.13699999999999998,147,RW,1994,1996
Joseph Noris,52,2,5,7,0.135,22,C,1971,1974
Antti Pihlstrom,54,2,5,7,0.13,10,LW/RW,2007,2009
Johan Witehall,54,2,5,7,0.13,16,LW,1998,2001
Taylor Leier,55,2,5,7,0.127,10,LW,2015,2018
Rob Flockhart,55,2,5,7,0.127,14,LW,1976,1981
Mark Popovic,81,2,5,7,0.086,20,D,2003,2010
Ron Ward,89,2,5,7,0.079,6,D,1969,1972
Irv Frew,96,2,5,7,0.073,146,D,1933,1936
Alek Stojanov,107,2,5,7,0.065,222,RW,1994,1997
Mike Backman,18,1,6,7,0.389,18,RW,1981,1984
Glen Seabrooke,19,1,6,7,0.368,4,C,1986,1989
Tony Cassolato,23,1,6,7,0.304,4,RW,1979,1982
Tomas Kundratek,30,1,6,7,0.233,10,D,2011,2013
Chris Winnes,33,1,6,7,0.212,6,RW,1990,1994
Ryan O'Marra,33,1,6,7,0.212,17,RW/C,2009,2012
Ray Gariepy,36,1,6,7,0.19399999999999998,43,D,1953,1956
Libor Zabransky,40,1,6,7,0.175,50,D,1996,1998
Jonas Frogren,41,1,6,7,0.171,28,D,2008,2009
Anton Belov,57,1,6,7,0.12300000000000001,34,D,2013,2014
Aaron Ness,71,1,6,7,0.099,22,D,2011,2020
Ben Harpur,103,1,6,7,0.068,79,D,2015,2021
Ryan Parent,106,1,6,7,0.066,36,D,2006,2011
John Jakopin,113,1,6,7,0.062,145,D,1997,2003
Riley Cote,156,1,6,7,0.045,411,LW,2006,2010
Ronald Fischer,18,0,7,7,0.389,6,D,1981,1983
Don Dietrich,28,0,7,7,0.25,10,D,1983,1986
Myron Stankiewicz,35,0,7,7,0.2,36,LW,1968,1969
Ryan Stone,35,0,7,7,0.2,55,LW,2007,2010
Mike McBain,64,0,7,7,0.109,22,D,1997,1999
Boris Valabik,80,0,7,7,0.08800000000000001,210,D,2007,2010
Tyler Randell,27,6,0,6,0.222,47,RW,2015,2016
John O'Flaherty,21,5,1,6,0.28600000000000003,0,LW,1940,1942
Jack Ingoldsby,29,5,1,6,0.207,15,RW,1942,1944
Gerry Geran,37,5,1,6,0.162,6,C,1917,1926
Jack Arbour,47,5,1,6,0.128,56,D,1926,1929
Peter Bartos,13,4,2,6,0.462,6,RW/C,2000,2001
Randy Bucyk,19,4,2,6,0.316,8,F,1985,1988
Joe Motzko,25,4,2,6,0.24,0,RW,2003,2009
Martin Gendron,30,4,2,6,0.2,10,RW,1994,1998
Jeff Heerema,32,4,2,6,0.188,6,RW,2002,2004
Doug Patey,45,4,2,6,0.133,8,F,1976,1979
Jack MacKell,45,4,2,6,0.133,59,D/RW,1919,1921
Roman Lyubimov,47,4,2,6,0.128,8,LW/RW,2016,2017
Niklas Nordgren,58,4,2,6,0.10300000000000001,34,RW,2005,2006
Billy Bell,73,4,2,6,0.08199999999999999,14,C,1917,1924
Freddie Hamilton,75,4,2,6,0.08,12,C/W,2013,2018
Harvey Rockburn,94,4,2,6,0.064,254,D,1929,1933
Art Lesieur,100,4,2,6,0.06,50,D,1928,1936
Alexei Yegorov,11,3,3,6,0.545,2,RW,1995,1997
Duane Wylie,14,3,3,6,0.429,2,C,1974,1977
Jason Ruff,14,3,3,6,0.429,10,LW,1992,1994
Bill Warwick,14,3,3,6,0.429,16,LW,1942,1944
Steve Alley,15,3,3,6,0.4,11,LW,1979,1981
Joe Papike,20,3,3,6,0.3,4,RW,1940,1945
Scott Gruhl,20,3,3,6,0.3,6,LW,1981,1988
Peter Eriksson,20,3,3,6,0.3,24,LW,1989,1990
Rod Norrish,21,3,3,6,0.28600000000000003,2,LW,1973,1975
Tony Hemmerling,22,3,3,6,0.273,4,LW,1935,1937
Alexandre Fortin,24,3,3,6,0.25,2,LW/C,2018,2019
Dave Dziurzynski,26,3,3,6,0.231,22,LW,2012,2016
Jason Zent,27,3,3,6,0.222,13,LW,1996,1999
Mark Paterson,29,3,3,6,0.207,33,D,1982,1986
Nicklas Jensen,31,3,3,6,0.19399999999999998,10,RW/LW,2012,2017
Bracken Kearns,35,3,3,6,0.171,22,C,2011,2017
Michal Sivek,38,3,3,6,0.158,14,C,2002,2003
Dave Morrison,39,3,3,6,0.154,4,C,1980,1985
Mitchell Stephens,41,3,3,6,0.146,10,C,2019,2021
Ben Hankinson,43,3,3,6,0.14,45,RW,1992,1995
Sheldon Dries,45,3,3,6,0.133,26,C/W,2018,2020
Tony Feltrin,48,3,3,6,0.125,65,D,1980,1986
Todd Harkins,48,3,3,6,0.125,78,C,1991,1994
Alexei Smirnov,52,3,3,6,0.115,20,LW,2002,2004
Jeremy Colliton,57,3,3,6,0.105,26,C,2005,2011
Ed Patterson,68,3,3,6,0.08800000000000001,56,RW,1993,1997
Josh Gratton,86,3,3,6,0.07,294,LW,2005,2009
John McCarthy,88,3,3,6,0.068,22,C,2009,2016
Helge Bostrom,96,3,3,6,0.063,58,D,1929,1933
Kevin Sawyer,110,3,3,6,0.055,403,LW,1995,2003
Percy Traub,130,3,3,6,0.046,217,D,1926,1929
Brandon Reid,13,2,4,6,0.462,0,C,2002,2007
Max Middendorf,13,2,4,6,0.462,6,C,1986,1991
Randy Heath,13,2,4,6,0.462,15,F,1984,1986
John Rogers,14,2,4,6,0.429,0,RW,1973,1975
Norman Tustin,18,2,4,6,0.33299999999999996,0,LW,1941,1942
Fred Hergerts,20,2,4,6,0.3,2,C,1934,1936
Dwayne Norris,20,2,4,6,0.3,8,RW,1993,1996
Jim Playfair,21,2,4,6,0.28600000000000003,51,D,1983,1989
Ralph Intranuovo,22,2,4,6,0.273,4,LW,1994,1997
Yakov Trenin,22,2,4,6,0.273,9,C/W,2019,2021
Tom Koivisto,22,2,4,6,0.273,10,D,2002,2003
Vesa Viitakoski,23,2,4,6,0.261,8,LW,1993,1996
Tom Mellor,26,2,4,6,0.231,25,D,1973,1975
Frank Breault,27,2,4,6,0.222,42,RW,1990,1993
Peter Smrek,28,2,4,6,0.214,18,D,2000,2002
Norm Milley,29,2,4,6,0.207,12,RW,2001,2006
Henry Harris,32,2,4,6,0.188,20,RW,1930,1931
Gary Coalter,34,2,4,6,0.17600000000000002,2,C,1973,1975
Ted Crowley,34,2,4,6,0.17600000000000002,12,D,1993,1999
Don Gillen,35,2,4,6,0.171,22,RW,1979,1982
Scott Sabourin,35,2,4,6,0.171,33,RW,2019,2020
Ron Lyons,36,2,4,6,0.16699999999999998,27,LW,1930,1931
Steve Pinizzotto,36,2,4,6,0.16699999999999998,74,RW,2011,2015
Eric Manlow,37,2,4,6,0.162,8,LW,2000,2004
Phil Hoene,37,2,4,6,0.162,22,LW,1972,1975
Guillaume Lefebvre,39,2,4,6,0.154,13,LW,2001,2010
Chris Minard,40,2,4,6,0.15,14,W/C,2007,2010
Andrei Skopintsev,40,2,4,6,0.15,32,D,1998,2001
Bobby Sanguinetti,45,2,4,6,0.133,8,D,2009,2013
Karl Stewart,69,2,4,6,0.087,68,LW,2003,2008
Dwayne Hay,79,2,4,6,0.076,22,LW,1997,2001
John Emmons,85,2,4,6,0.071,64,C,1999,2002
Jack McVicar,88,2,4,6,0.068,63,D,1930,1932
Jeremy Reich,99,2,4,6,0.061,161,LW,2003,2008
Sami Helenius,155,2,4,6,0.039,260,D,1996,2003
Timo Jutila,10,1,5,6,0.6,13,D,1984,1985
Rob Gladney,14,1,5,6,0.429,4,D,1982,1984
Andrew Miller,15,1,5,6,0.4,0,C/RW,2014,2016
Jozef Balej,18,1,5,6,0.33299999999999996,4,RW,2003,2006
Bob Attwell,22,1,5,6,0.273,0,RW,1979,1981
Martins Karsums,24,1,5,6,0.25,6,LW/RW,2008,2009
Daniel Poudrier,25,1,5,6,0.24,10,D,1985,1988
Mark Plantery,25,1,5,6,0.24,14,D,1980,1981
Ty Wishart,26,1,5,6,0.231,10,D,2008,2012
Denis Tolpeko,26,1,5,6,0.231,24,LW/RW,2007,2008
Brian McReynolds,30,1,5,6,0.2,8,C,1989,1994
Willie Marshall,33,1,5,6,0.182,2,C,1952,1959
Libor Hajek,33,1,5,6,0.182,18,D,2018,2021
Andy Welinski,35,1,5,6,0.171,8,D,2017,2021
A.J. Greer,37,1,5,6,0.162,47,LW,2016,2019
Jason Podollan,41,1,5,6,0.146,19,RW,1996,2002
Martin Simard,44,1,5,6,0.136,183,RW,1990,1993
Lawrence Pilut,46,1,5,6,0.13,24,D,2018,2020
Tony Savage,49,1,5,6,0.122,6,D,1934,1935
Denis Tsygurov,51,1,5,6,0.11800000000000001,45,D,1993,1996
Bob Falkenberg,54,1,5,6,0.111,26,D,1966,1972
Jack Lancien,63,1,5,6,0.095,35,D,1946,1951
Jim Hay,75,1,5,6,0.08,22,D,1952,1955
Brad Miller,82,1,5,6,0.073,321,D,1988,1994
Stewart Malgunas,129,1,5,6,0.047,144,D,1993,2000
Kelly Pratt,22,0,6,6,0.273,15,RW,1974,1975
Rolly Roulston,24,0,6,6,0.25,10,LW/D,1935,1938
Greg Andrusak,28,0,6,6,0.214,16,D,1993,2000
Jeff Serowik,28,0,6,6,0.214,16,D,1990,1999
Isac Lundestrom,32,0,6,6,0.188,2,C/LW,2018,2021
Matthew Corrente,34,0,6,6,0.17600000000000002,68,D,2009,2011
Darryl Laplante,35,0,6,6,0.171,10,C,1997,2000
Jonas Holos,39,0,6,6,0.154,10,D,2010,2011
Juho Lammikko,40,0,6,6,0.15,6,C/LW,2018,2021
Tim Conboy,59,0,6,6,0.102,121,D,2007,2010
Todd Rohloff,75,0,6,6,0.08,40,D,2001,2004
Matt Smaby,122,0,6,6,0.049,106,D,2007,2011
Eddie McCalmon,39,5,0,5,0.128,14,RW,1927,1931
Petr Kalus,11,4,1,5,0.455,6,LW/RW,2006,2010
Arto Javanainen,14,4,1,5,0.35700000000000004,2,RW,1984,1985
Jake Evans,18,4,1,5,0.278,0,C/RW,2019,2021
Ryan Poehling,28,4,1,5,0.179,4,C,2018,2021
Melville Vail,50,4,1,5,0.1,18,D,1928,1930
Brandon Mashinter,64,4,1,5,0.078,50,LW,2010,2016
Myles Lane,71,4,1,5,0.07,41,D,1928,1934
Joey Tetarenko,73,4,1,5,0.068,176,RW,2000,2004
Matt Kassian,76,4,1,5,0.066,167,LW,2010,2014
Ralph Taylor,99,4,1,5,0.051,169,D,1927,1930
Ron Snell,7,3,2,5,0.7140000000000001,6,RW,1968,1970
Gord Fashoway,13,3,2,5,0.385,14,LW,1950,1951
Rob Plumb,14,3,2,5,0.35700000000000004,2,C,1977,1979
Patrick Lebeau,15,3,2,5,0.33299999999999996,6,LW,1990,1999
Xavier Delisle,16,3,2,5,0.313,6,C,1998,2001
Tomas Kurka,17,3,2,5,0.294,2,LW/RW,2002,2004
Ryan Vesce,19,3,2,5,0.263,4,C/RW,2008,2010
Timofei Shishkanov,24,3,2,5,0.20800000000000002,6,LW,2003,2006
Lloyd Doran,24,3,2,5,0.20800000000000002,10,C,1946,1947
Yan Kaminsky,26,3,2,5,0.192,4,RW,1993,1995
Noah Gregor,31,3,2,5,0.161,10,C,2019,2021
Barry Wilcox,33,3,2,5,0.152,15,C,1972,1975
Will Acton,33,3,2,5,0.152,26,C/LW,2013,2015
Zack Mitchell,34,3,2,5,0.147,4,RW/C,2016,2018
Lynn Loyns,34,3,2,5,0.147,21,LW,2002,2006
Rennison Manners,37,3,2,5,0.135,14,C,1929,1931
Aaron Gagnon,38,3,2,5,0.132,2,C/RW,2009,2013
Peter Slobodian,41,3,2,5,0.122,54,D,1940,1941
Mike Sislo,42,3,2,5,0.11900000000000001,6,RW,2013,2016
Eddie Ouellette,43,3,2,5,0.11599999999999999,11,LW,1935,1936
Harold Halderson,44,3,2,5,0.114,65,D,1926,1927
Dave Richardson,45,3,2,5,0.111,27,LW,1963,1968
George Redding,55,3,2,5,0.091,23,LW,1924,1926
Jack Caffery,57,3,2,5,0.08800000000000001,22,C,1954,1958
Bill Hutton,64,3,2,5,0.078,8,D,1929,1931
Dylan McIlrath,66,3,2,5,0.076,121,D,2013,2020
Bill Regan,67,3,2,5,0.075,67,D,1929,1933
Rod Smylie,74,3,2,5,0.068,12,F,1920,1926
Harry Foster,83,3,2,5,0.06,32,D,1929,1935
Sergei Kharin,7,2,3,5,0.7140000000000001,2,RW,1990,1991
Tony Virta,8,2,3,5,0.625,0,RW/C,2001,2002
Fred Perlini,8,2,3,5,0.625,0,C,1981,1984
Brian Loney,12,2,3,5,0.41700000000000004,6,RW,1995,1996
Ken Gernander,12,2,3,5,0.41700000000000004,6,RW,1995,2004
Larry Floyd,12,2,3,5,0.41700000000000004,9,RW,1982,1984
Dan Fridgen,13,2,3,5,0.385,2,LW,1981,1983
George Senick,13,2,3,5,0.385,8,LW,1952,1953
John Miner,14,2,3,5,0.35700000000000004,16,D,1987,1988
Les Costello,15,2,3,5,0.33299999999999996,11,LW,1947,1950
Carson McMillan,16,2,3,5,0.313,11,RW/C,2010,2014
Konstantin Pushkaryov,17,2,3,5,0.294,8,RW/LW,2005,2007
Daniel Dore,17,2,3,5,0.294,59,RW,1989,1991
Brett MacLean,18,2,3,5,0.278,4,RW,2010,2012
Bob Stephenson,18,2,3,5,0.278,4,F,1979,1980
Gavin Bayreuther,19,2,3,5,0.263,10,D,2018,2019
Josh Currie,21,2,3,5,0.23800000000000002,2,RW,2018,2019
John Byce,21,2,3,5,0.23800000000000002,6,RW,1989,1992
Robert Burakovsky,23,2,3,5,0.217,6,RW,1993,1994
Hank Blade,24,2,3,5,0.20800000000000002,2,LW,1946,1948
Barrett Hayton,24,2,3,5,0.20800000000000002,14,C/LW,2019,2021
Raymond Maluta,25,2,3,5,0.2,6,D,1975,1977
Christian Matte,25,2,3,5,0.2,12,RW,1996,2001
Mitch Wilson,26,2,3,5,0.192,104,RW,1984,1987
Matt Keith,27,2,3,5,0.185,14,C/W,2003,2008
Andrej Nedorost,28,2,3,5,0.179,12,C/W,2001,2004
Johnny Matz,30,2,3,5,0.16699999999999998,0,F,1924,1925
Eric Houde,30,2,3,5,0.16699999999999998,4,C,1996,1999
Jakub Nakladal,30,2,3,5,0.16699999999999998,6,D,2015,2017
Bruce Cline,30,2,3,5,0.16699999999999998,10,RW,1956,1957
Vic Heyliger,33,2,3,5,0.152,2,C,1937,1944
Kelly Fairchild,34,2,3,5,0.147,6,C,1995,2002
Sam Carrick,34,2,3,5,0.147,15,C,2014,2020
Mikhail Vorobyov,35,2,3,5,0.14300000000000002,8,C,2018,2020
Clayton Pachal,35,2,3,5,0.14300000000000002,95,C,1976,1979
Jakob Lilja,37,2,3,5,0.135,2,LW,2019,2020
John Gilmour,37,2,3,5,0.135,18,D,2017,2020
Glenn Patrick,38,2,3,5,0.132,72,D,1973,1977
Kurtis Gabriel,38,2,3,5,0.132,98,RW,2015,2019
Kyle Rau,42,2,3,5,0.11900000000000001,6,C/LW,2015,2021
John Quenneville,42,2,3,5,0.11900000000000001,6,C/W,2016,2020
Joonas Kemppainen,44,2,3,5,0.114,4,C,2015,2016
Pierre-Cedric Labrie,46,2,3,5,0.109,65,LW,2011,2014
Brandon Gormley,58,2,3,5,0.086,20,D,2013,2016
Martin Sonnenberg,63,2,3,5,0.079,21,LW,1998,2004
Alexandre Bolduc,65,2,3,5,0.077,44,C,2008,2015
Rumun Ndur,69,2,3,5,0.07200000000000001,137,D,1996,2000
Cody Bass,75,2,3,5,0.067,107,C,2007,2017
Paul Raymond,76,2,3,5,0.066,6,RW,1932,1939
Zach Sill,93,2,3,5,0.054000000000000006,98,C/LW,2013,2016
Kirill Kaprizov,5,1,4,5,1.0,2,LW/RW,2020,2021
Ville Heinola,9,1,4,5,0.556,4,D,2019,2021
Mike Iggulden,12,1,4,5,0.41700000000000004,4,RW/C,2007,2009
Chris Marinucci,13,1,4,5,0.385,2,RW,1994,1997
Darren Dietz,13,1,4,5,0.385,13,D,2015,2016
Alexander Vasyunov,18,1,4,5,0.278,0,LW,2010,2011
Denny Felsner,18,1,4,5,0.278,6,LW,1991,1995
Calle Rosen,20,1,4,5,0.25,8,D,2017,2020
Jon Kalinski,22,1,4,5,0.22699999999999998,0,C/LW,2008,2010
Kevin Miehm,22,1,4,5,0.22699999999999998,8,C,1992,1994
Max Reinhart,23,1,4,5,0.217,6,C,2012,2015
Mike Stevens,23,1,4,5,0.217,29,LW,1984,1990
Danny O'Regan,25,1,4,5,0.2,2,C/RW,2016,2019
George Harris,26,1,4,5,0.192,4,RW,1967,1968
Ryan Hamilton,30,1,4,5,0.16699999999999998,8,LW,2011,2015
Dmitri Filimonov,30,1,4,5,0.16699999999999998,18,D,1993,1994
Phil Besler,30,1,4,5,0.16699999999999998,18,RW,1935,1939
Bert Hirschfeld,33,1,4,5,0.152,2,LW,1949,1951
Jim Mikol,34,1,4,5,0.147,8,D,1962,1965
Gary Yaremchuk,34,1,4,5,0.147,28,C,1981,1985
Bruce Shoebottom,35,1,4,5,0.14300000000000002,53,D,1987,1991
Andrew McKim,38,1,4,5,0.132,6,C,1992,1995
Bill Kitchen,41,1,4,5,0.122,40,D,1981,1985
Yevgeni Korolyov,42,1,4,5,0.11900000000000001,20,D,1999,2002
Rick McCann,43,1,4,5,0.11599999999999999,6,C,1967,1975
Jaycob Megna,43,1,4,5,0.11599999999999999,14,D,2016,2019
Patrice Cormier,49,1,4,5,0.102,18,C,2010,2016
Ron Jones,54,1,4,5,0.09300000000000001,31,D,1971,1976
Al Rourke,55,1,4,5,0.091,31,D,2003,2008
Louis Holmes,59,1,4,5,0.085,6,C,1931,1933
Jean Pusie,61,1,4,5,0.08199999999999999,28,D,1930,1936
Jean-Francois Fortin,71,1,4,5,0.07,42,D,2001,2004
Bill Butters,72,1,4,5,0.069,77,D,1977,1979
Alain Nasreddine,74,1,4,5,0.068,84,D,1998,2008
Chris Pryor,82,1,4,5,0.061,122,D,1984,1990
John Zeiler,90,1,4,5,0.055999999999999994,87,RW/C,2006,2011
Serge Lajeunesse,103,1,4,5,0.049,103,D,1970,1975
Ron Shudra,10,0,5,5,0.5,6,D,1987,1988
Petri Kontiola,12,0,5,5,0.41700000000000004,6,C,2007,2008
Milan Chalupa,14,0,5,5,0.35700000000000004,6,D,1984,1985
Joe Hicketts,22,0,5,5,0.22699999999999998,4,D,2017,2020
Joe Kowal,22,0,5,5,0.22699999999999998,13,LW,1976,1978
Dick Lamby,22,0,5,5,0.22699999999999998,22,D,1978,1981
Milan Tichy,23,0,5,5,0.217,40,D,1992,1996
Randy Skarda,26,0,5,5,0.192,11,D,1989,1992
Tyler Wotherspoon,30,0,5,5,0.16699999999999998,4,D,2013,2017
Craig Mills,31,0,5,5,0.161,36,RW,1995,1999
Alex Singbush,32,0,5,5,0.156,15,D,1940,1941
Anders Myrvold,33,0,5,5,0.152,12,D,1995,2004
Phil Von Stefenelli,33,0,5,5,0.152,23,D,1995,1997
Matt Block,35,0,5,5,0.14300000000000002,97,D,1988,1993
Riley Stillman,36,0,5,5,0.139,18,D,2018,2021
Michael McLeod,37,0,5,5,0.135,19,C,2018,2021
Jordan Schmaltz,42,0,5,5,0.11900000000000001,12,D,2016,2019
Ralph MacSweyn,47,0,5,5,0.106,10,D,1967,1972
Patrick Russell,51,0,5,5,0.098,14,RW,2018,2021
Ian Herbers,65,0,5,5,0.077,79,D,1993,2000
Anton Lindholm,66,0,5,5,0.076,16,D,2016,2020
Gordie Dwyer,108,0,5,5,0.046,394,LW,1999,2004
Dan McCarthy,5,4,0,4,0.8,4,C,1980,1981
Nathan Bastian,11,4,0,4,0.364,12,RW,2018,2021
Jeff Madill,14,4,0,4,0.28600000000000003,46,RW,1990,1991
Ron Hoover,18,4,0,4,0.222,31,C,1989,1992
Jack Keating,20,4,0,4,0.2,4,LW,1938,1940
Dave Hynes,22,4,0,4,0.182,2,LW,1973,1975
Jesper Boqvist,39,4,0,4,0.10300000000000001,10,C/LW,2019,2021
Jim Cain,61,4,0,4,0.066,35,D,1924,1926
Morgan Geekie,4,3,1,4,1.0,2,C/RW,2019,2021
Smokey Harris,6,3,1,4,0.667,8,LW,1924,1925
Lin Bend,8,3,1,4,0.5,2,C,1942,1943
William Knott,14,3,1,4,0.28600000000000003,9,D,1941,1942
Doug Kostynski,15,3,1,4,0.267,4,C,1983,1985
Reto von Arx,19,3,1,4,0.21100000000000002,4,C,2000,2001
Noah Clarke,21,3,1,4,0.19,4,LW,2003,2008
Chris Langevin,22,3,1,4,0.182,22,LW,1983,1986
Archie Henderson,23,3,1,4,0.174,92,RW,1980,1983
Pat Murray,25,3,1,4,0.16,15,LW,1990,1992
Steven Regier,26,3,1,4,0.154,8,LW,2005,2009
Junior Lessard,27,3,1,4,0.14800000000000002,23,RW,2005,2008
Mike Berger,30,3,1,4,0.133,67,D,1987,1989
Mike Nykoluk,32,3,1,4,0.125,20,C,1956,1957
Maxim Mamin,33,3,1,4,0.121,12,LW/RW,2017,2019
Alexander Urbom,34,3,1,4,0.11800000000000001,28,D,2010,2014
Laurent Dauphin,35,3,1,4,0.114,18,C/LW,2015,2019
Brian McCutcheon,37,3,1,4,0.10800000000000001,7,LW,1974,1977
Neil Nicholson,39,3,1,4,0.10300000000000001,23,D,1969,1978
Hal Picketts,48,3,1,4,0.083,32,RW,1933,1934
Ben Simon,81,3,1,4,0.049,47,C,2001,2006
David Koci,142,3,1,4,0.027999999999999997,461,D/LW,2006,2011
Ralph Barahona,6,2,2,4,0.667,0,C,1990,1992
Kari Makkonen,9,2,2,4,0.444,0,RW,1979,1980
Aleksi Saarela,9,2,2,4,0.444,0,C/LW,2018,2020
Bill Thomson,9,2,2,4,0.444,0,C/RW,1938,1944
Yanick Lehoux,10,2,2,4,0.4,6,C/RW,2005,2007
Les Ramsay,11,2,2,4,0.364,2,LW,1944,1945
Gary Burns,11,2,2,4,0.364,18,F,1980,1982
Rich Costello,12,2,2,4,0.33299999999999996,2,C,1983,1986
Tom Brennan,12,2,2,4,0.33299999999999996,2,RW,1943,1945
Don Smillie,12,2,2,4,0.33299999999999996,4,F,1933,1934
Bruce Eakin,13,2,2,4,0.308,4,C,1981,1986
Cy Thomas,14,2,2,4,0.28600000000000003,12,F,1947,1948
Roland Stoltz,14,2,2,4,0.28600000000000003,14,RW,1981,1982
Hunter Shinkaruk,15,2,2,4,0.267,4,C/LW,2015,2017
Paul Brydges,15,2,2,4,0.267,4,C,1986,1987
Ken Strong,15,2,2,4,0.267,6,LW,1982,1985
Roger Picard,15,2,2,4,0.267,21,RW,1967,1968
Max Veronneau,16,2,2,4,0.25,0,RW,2018,2020
Lukas Kaspar,16,2,2,4,0.25,8,LW/RW,2007,2009
Jared Aulin,17,2,2,4,0.235,0,C/RW,2002,2003
Derek Mayer,17,2,2,4,0.235,8,D,1993,1994
Nathan Walker,17,2,2,4,0.235,12,LW,2017,2020
Guy Leveque,17,2,2,4,0.235,21,C,1992,1994
Mikael Lindholm,18,2,2,4,0.222,2,C,1989,1990
Jeff Christian,18,2,2,4,0.222,17,LW,1991,1998
Charles Corrigan,19,2,2,4,0.21100000000000002,2,RW,1937,1941
Brandon Kozun,20,2,2,4,0.2,6,RW,2014,2015
Yevgeni Svechnikov,20,2,2,4,0.2,10,RW/LW,2016,2020
Darren Banks,20,2,2,4,0.2,73,LW,1992,1994
Matt Hussey,21,2,2,4,0.19,2,C,2003,2007
Lane MacDermid,21,2,2,4,0.19,36,LW,2011,2014
Rusty Fitzgerald,25,2,2,4,0.16,12,C,1994,1996
Al McLeod,26,2,2,4,0.154,24,D,1973,1974
Kristian Kudroc,26,2,2,4,0.154,38,D,2000,2004
Viktor Svedberg,27,2,2,4,0.14800000000000002,4,D,2015,2016
Ed Lowrey,27,2,2,4,0.14800000000000002,6,C,1917,1921
Mark Kolesar,28,2,2,4,0.14300000000000002,14,C,1995,1997
Len Haley,30,2,2,4,0.133,14,RW,1959,1961
Kirill Safronov,35,2,2,4,0.114,16,D,2001,2003
Mika Pyorala,36,2,2,4,0.111,10,LW/C,2009,2010
Jan Mursak,46,2,2,4,0.087,8,C,2010,2013
Clarence Boucher,47,2,2,4,0.085,133,D,1926,1928
Alvin Jones,50,2,2,4,0.08,36,D,1938,1943
Steven Goertzen,68,2,2,4,0.059000000000000004,83,RW/LW,2005,2010
Steve MacIntyre,91,2,2,4,0.044000000000000004,175,LW,2008,2013
John English,3,1,3,4,1.3330000000000002,4,D,1987,1988
Ty Smith,4,1,3,4,1.0,4,D,2020,2021
Gary Marsh,7,1,3,4,0.5710000000000001,4,LW,1967,1969
Adam Brooks,8,1,3,4,0.5,0,C,2019,2021
Tomas Vlasak,10,1,3,4,0.4,2,LW/RW,2000,2001
Bob Collyard,10,1,3,4,0.4,4,C,1973,1974
Gord McTavish,11,1,3,4,0.364,2,C,1978,1980
Elmer Maracle,11,1,3,4,0.364,4,LW,1930,1931
Tomas Kubalik,12,1,3,4,0.33299999999999996,6,RW,2010,2012
Brian Felsner,12,1,3,4,0.33299999999999996,12,C,1997,1998
Brent Gretzky,13,1,3,4,0.308,2,C,1993,1995
Adam Johnson,13,1,3,4,0.308,2,C/LW,2018,2020
Matt Pelech,13,1,3,4,0.308,38,D/RW,2008,2014
Brad Aitken,14,1,3,4,0.28600000000000003,25,LW,1987,1991
Robert Crawford,16,1,3,4,0.25,6,RW,1980,1983
Keith Osborne,16,1,3,4,0.25,16,RW,1989,1993
Neil Eisenhut,16,1,3,4,0.25,21,C,1993,1995
Frank Waite,17,1,3,4,0.235,4,C,1930,1931
Don Campbell,17,1,3,4,0.235,8,LW,1943,1944
Clarence Saunders,18,1,3,4,0.222,4,RW,1933,1934
Ed Barry,19,1,3,4,0.21100000000000002,2,D,1946,1947
Tyler Gaudet,20,1,3,4,0.2,0,C,2014,2017
Dakota Mermis,20,1,3,4,0.2,4,D,2017,2021
Richie Regehr,20,1,3,4,0.2,6,D,2005,2007
Frederic St-Denis,21,1,3,4,0.19,10,D,2011,2015
Frank Mathers,23,1,3,4,0.174,4,D,1948,1952
Chuck Holmes,23,1,3,4,0.174,10,RW,1958,1962
Micki DuPont,23,1,3,4,0.174,12,D,2001,2008
Clark Bishop,25,1,3,4,0.16,10,C,2018,2020
Stanislav Galiyev,26,1,3,4,0.154,4,LW/RW,2014,2016
Paul Brousseau,26,1,3,4,0.154,29,RW,1995,2001
Lee Giffin,27,1,3,4,0.14800000000000002,9,RW,1986,1988
Maxime Macenauer,29,1,3,4,0.138,18,C/LW,2011,2012
Norm Corcoran,29,1,3,4,0.138,21,C,1949,1956
Mark Visheau,29,1,3,4,0.138,107,D,1993,1999
Fern Headley,30,1,3,4,0.133,10,D,1924,1925
Ilkka Pikkarainen,31,1,3,4,0.129,10,RW/LW,2009,2010
Jay Henderson,33,1,3,4,0.121,37,LW,1998,2001
Yevgeni Grachyov,34,1,3,4,0.11800000000000001,2,C/W,2010,2012
William Inglis,36,1,3,4,0.111,4,C,1967,1971
Miloslav Guren,36,1,3,4,0.111,16,D,1998,2000
Kent Paynter,37,1,3,4,0.10800000000000001,69,D,1987,1994
Blake Pietila,38,1,3,4,0.105,12,LW,2015,2019
Johan Lindbom,38,1,3,4,0.105,28,RW,1997,1998
Tuomas Gronman,38,1,3,4,0.105,38,D,1996,1998
Sean Shanahan,40,1,3,4,0.1,47,LW,1975,1978
Reid Bailey,40,1,3,4,0.1,105,D,1980,1984
Dave Tomlinson,42,1,3,4,0.095,28,C,1991,1995
Dave Thomlinson,42,1,3,4,0.095,50,LW,1989,1995
Chris Bigras,46,1,3,4,0.087,18,D,2015,2018
Seth Helgeson,50,1,3,4,0.08,50,D,2014,2017
Ales Pisa,53,1,3,4,0.075,26,D,2001,2003
Staffan Kronwall,66,1,3,4,0.061,23,D,2005,2010
Francis Lessard,115,1,3,4,0.035,346,RW,2001,2011
Dean Malkoc,116,1,3,4,0.034,299,D,1995,1999
Howard Scruton,4,0,4,4,1.0,9,D,1982,1983
Todd Richards,8,0,4,4,0.5,4,D,1990,1992
Norm Burns,11,0,4,4,0.364,2,C,1941,1942
Alexander True,12,0,4,4,0.33299999999999996,2,C,2019,2020
Sergei Petrenko,14,0,4,4,0.28600000000000003,0,LW,1993,1994
Jussi Timonen,14,0,4,4,0.28600000000000003,6,D,2006,2007
Rick Lessard,15,0,4,4,0.267,18,D,1988,1992
Trevor Halverson,17,0,4,4,0.235,28,LW,1998,1999
Zach Hamill,20,0,4,4,0.2,4,C/RW,2009,2012
Paul Shakes,21,0,4,4,0.19,12,D,1973,1974
Michel Lachance,21,0,4,4,0.19,22,D,1978,1979
Dustin Kohn,22,0,4,4,0.182,4,D,2009,2010
John Newberry,22,0,4,4,0.182,6,C,1982,1986
Joel Vermin,24,0,4,4,0.16699999999999998,4,W/C,2015,2017
Scott Sandelin,25,0,4,4,0.16,2,D,1986,1992
Arto Blomsten,25,0,4,4,0.16,8,D,1993,1996
Joby Messier,25,0,4,4,0.16,24,D,1992,1995
Jean-Philippe Cote,27,0,4,4,0.14800000000000002,26,D,2005,2014
Keith Allen,28,0,4,4,0.14300000000000002,8,D,1953,1955
Erik Brannstrom,33,0,4,4,0.121,16,D,2018,2020
Walter Kalbfleisch,36,0,4,4,0.111,32,D,1933,1937
Sasha Lakovic,37,0,4,4,0.10800000000000001,118,LW,1996,1999
Jonas Ronnqvist,38,0,4,4,0.105,14,C,2000,2001
Andrew Bodnarchuk,42,0,4,4,0.095,16,D,2009,2016
Grant Martin,44,0,4,4,0.091,55,C,1983,1987
Ray Schultz,45,0,4,4,0.08900000000000001,155,D,1997,2003
Joe Callahan,46,0,4,4,0.087,16,D,2008,2011
Colby Robak,47,0,4,4,0.085,25,D,2011,2015
Lou Marcon,60,0,4,4,0.067,42,D,1958,1963
Brad DeFauw,9,3,0,3,0.33299999999999996,2,LW,2002,2003
Norm Dennis,12,3,0,3,0.25,11,C,1968,1972
Jeff Ulmer,21,3,0,3,0.14300000000000002,8,C/W,2000,2001
Joel L'Esperance,21,3,0,3,0.14300000000000002,8,C/RW,2018,2020
Zdenek Blatny,25,3,0,3,0.12,8,LW/C,2002,2006
Leth Graham,27,3,0,3,0.111,0,LW,1920,1926
Dave MacKay,29,3,0,3,0.10300000000000001,26,D,1940,1941
Frank McGuire,36,3,0,3,0.083,6,LW,1926,1928
Cam Severson,37,3,0,3,0.081,63,LW,2002,2006
Konstantin Shafranov,5,2,1,3,0.6,0,RW,1996,1997
Jean-Marc Richard,5,2,1,3,0.6,2,D,1987,1990
Connell Broden,6,2,1,3,0.5,2,C,1955,1958
David Haas,7,2,1,3,0.429,7,LW,1990,1994
Andre Hidi,7,2,1,3,0.429,9,LW,1983,1985
Akim Aliu,7,2,1,3,0.429,26,D/RW,2011,2013
Rick Boh,8,2,1,3,0.375,4,C,1987,1988
Stan Smith,9,2,1,3,0.33299999999999996,0,C,1939,1941
Rollie McLenahan,9,2,1,3,0.33299999999999996,10,D,1945,1946
Martin Kaut,10,2,1,3,0.3,4,RW,2019,2021
David Laliberte,11,2,1,3,0.273,6,RW,2009,2010
Kieffer Bellows,12,2,1,3,0.25,2,LW,2019,2021
Joel Kiviranta,12,2,1,3,0.25,4,LW/RW,2019,2021
Todd Bidner,12,2,1,3,0.25,7,C,1981,1982
Erik Andersson,12,2,1,3,0.25,8,LW,1997,1998
Buddy Robinson,12,2,1,3,0.25,13,RW,2015,2021
C.J. Smith,13,2,1,3,0.231,0,LW,2016,2019
Hal Brown,13,2,1,3,0.231,2,RW,1945,1946
David Gosselin,13,2,1,3,0.231,11,LW,1999,2002
Rod Graham,14,2,1,3,0.214,7,LW,1974,1975
Shane Harper,14,2,1,3,0.214,18,RW,2016,2017
Tim Lenardon,15,2,1,3,0.2,4,C,1986,1990
Cam Paddock,16,2,1,3,0.188,0,C/RW,2008,2009
Edward Leier,16,2,1,3,0.188,2,C,1949,1951
Winston Juckes,16,2,1,3,0.188,6,LW,1947,1950
Ron Boehm,16,2,1,3,0.188,10,LW,1967,1968
Oliver Lauridsen,16,2,1,3,0.188,44,D,2012,2015
Bill Heindl,18,2,1,3,0.16699999999999998,0,LW,1970,1973
Steve Hrymnak,18,2,1,3,0.16699999999999998,4,D,1951,1953
Jack Laviolette,18,2,1,3,0.16699999999999998,6,D,1917,1918
Len Ronson,18,2,1,3,0.16699999999999998,10,LW,1960,1969
Carl Corazzini,19,2,1,3,0.158,2,C,2003,2007
Kalle Kossila,19,2,1,3,0.158,4,C/LW,2016,2019
Givani Smith,21,2,1,3,0.14300000000000002,9,RW/LW,2019,2021
Sean Collins,21,2,1,3,0.14300000000000002,12,D,2008,2012
Maxim Mayorov,22,2,1,3,0.136,2,LW/RW,2008,2012
Dan Currie,22,2,1,3,0.136,4,LW,1990,1994
Chris Brown,23,2,1,3,0.13,21,RW/C,2012,2016
Drew Larman,26,2,1,3,0.115,4,C,2006,2010
Lou Crawford,26,2,1,3,0.115,29,LW,1989,1992
Dwight Helminen,27,2,1,3,0.111,0,C,2008,2010
Tim Sheehy,27,2,1,3,0.111,0,RW,1977,1980
Patrick Brown,29,2,1,3,0.10300000000000001,8,C/RW,2014,2020
Tavis Hansen,34,2,1,3,0.08800000000000001,16,RW,1994,2001
Peter LeBoutillier,35,2,1,3,0.086,176,RW,1996,1998
Gene Carrigan,37,2,1,3,0.081,13,C,1930,1935
Jeremy Lauzon,39,2,1,3,0.077,31,D,2018,2021
Petteri Lindbohm,40,2,1,3,0.075,37,D,2014,2017
Steve Martinson,49,2,1,3,0.061,244,LW,1987,1992
Connor Clifton,50,2,1,3,0.06,27,D,2018,2021
Trevor Gillies,57,2,1,3,0.053,261,LW,2005,2012
Shep Mayer,2,1,2,3,1.5,4,F,1942,1943
Angie Moretto,5,1,2,3,0.6,2,C,1976,1977
Ike Klingbeil,5,1,2,3,0.6,2,D,1936,1937
Geordie Robertson,5,1,2,3,0.6,7,C,1982,1983
Andy Roach,5,1,2,3,0.6,10,D,2005,2006
Zach Senyshyn,6,1,2,3,0.5,0,RW,2018,2020
Janne Niskala,6,1,2,3,0.5,6,D,2008,2009
Josh Norris,7,1,2,3,0.429,0,C,2019,2021
Murray Kuntz,7,1,2,3,0.429,0,LW,1974,1975
Jim Anderson,7,1,2,3,0.429,2,LW,1967,1968
Christian Proulx,7,1,2,3,0.429,20,D,1993,1994
Peter Loob,8,1,2,3,0.375,0,D,1984,1985
Darrin Lowe,8,1,2,3,0.375,0,RW,1983,1984
Trevor Murphy,8,1,2,3,0.375,0,D,2017,2018
Jacques Toupin,8,1,2,3,0.375,0,RW,1943,1944
Mark Cundari,8,1,2,3,0.375,2,D,2012,2014
Brad Moran,8,1,2,3,0.375,4,C,2001,2007
Russ Adam,8,1,2,3,0.375,11,C,1982,1983
Dale McTavish,9,1,2,3,0.33299999999999996,2,RW,1996,1997
Lloyd Gronsdahl,10,1,2,3,0.3,0,RW,1941,1942
Nakina Smith,10,1,2,3,0.3,0,C,1943,1944
Eetu Luostarinen,10,1,2,3,0.3,0,C,2019,2021
Johan Harju,10,1,2,3,0.3,2,LW,2010,2011
Art Herchenratter,10,1,2,3,0.3,2,LW,1940,1941
Andrei Mironov,10,1,2,3,0.3,12,D,2017,2018
Reg Bentley,11,1,2,3,0.273,2,LW,1942,1943
Marcel Dheere,11,1,2,3,0.273,2,LW,1942,1943
Miroslav Zalesak,12,1,2,3,0.25,0,RW/C,2002,2004
Gilles Dube,12,1,2,3,0.25,2,LW,1949,1954
Janis Sprukts,14,1,2,3,0.214,2,C,2006,2009
Sean Haggerty,14,1,2,3,0.214,4,LW,1995,2001
Pierre Rioux,14,1,2,3,0.214,4,LW,1982,1983
Philip McRae,15,1,2,3,0.2,2,C/W,2010,2011
Paul Comrie,15,1,2,3,0.2,4,C,1999,2000
Hugh Plaxton,15,1,2,3,0.2,4,C,1932,1933
Jim Vesey,15,1,2,3,0.2,7,C,1988,1992
Mikko Lehtonen,15,1,2,3,0.2,8,D,2006,2007
Ben Hanowski,16,1,2,3,0.188,2,RW/LW,2012,2014
Paul Houck,16,1,2,3,0.188,2,RW,1985,1988
Zdenek Kutlak,16,1,2,3,0.188,4,D,2000,2004
Casey Borer,16,1,2,3,0.188,9,D,2007,2010
Jim Archibald,16,1,2,3,0.188,45,RW,1984,1987
Michael Mersch,17,1,2,3,0.17600000000000002,0,LW,2015,2016
Wes Trainor,17,1,2,3,0.17600000000000002,6,F,1948,1949
Tomas Mojzis,17,1,2,3,0.17600000000000002,14,D,2005,2009
Tom Cavanagh,18,1,2,3,0.16699999999999998,4,C,2007,2009
Ray Barry,18,1,2,3,0.16699999999999998,6,C,1951,1952
Steven Clippingdale,19,1,2,3,0.158,9,F,1976,1980
Scott Metcalfe,19,1,2,3,0.158,18,LW/C,1987,1990
Marek Posmyk,19,1,2,3,0.158,20,D,1999,2001
Danny Schock,20,1,2,3,0.15,0,LW,1969,1971
Moylan McDonell,22,1,2,3,0.136,2,D,1920,1921
Andrew Peeke,22,1,2,3,0.136,4,D,2019,2021
Hudson Fasching,22,1,2,3,0.136,8,RW,2015,2021
Greg Parks,23,1,2,3,0.13,6,C,1990,1993
Kaspars Astasenko,23,1,2,3,0.13,8,D,1999,2001
Mike Boland,23,1,2,3,0.13,29,D,1974,1979
Dennis Gilbert,23,1,2,3,0.13,40,D,2018,2021
Norm Beaudin,25,1,2,3,0.12,4,RW,1967,1971
Andreas Thuresson,25,1,2,3,0.12,6,LW/RW,2009,2011
Kimbi Daniels,27,1,2,3,0.111,4,C,1990,1992
Christian Thomas,27,1,2,3,0.111,9,RW,2012,2016
Juuso Valimaki,27,1,2,3,0.111,14,D,2018,2021
Erik Westrum,27,1,2,3,0.111,22,C,2003,2007
Hank Lammens,27,1,2,3,0.111,22,D,1993,1994
Andy Branigan,27,1,2,3,0.111,31,D,1940,1942
Fred Speck,28,1,2,3,0.107,2,C,1968,1972
Rasmus Asplund,30,1,2,3,0.1,6,C/W,2019,2021
Jerry D'Amigo,31,1,2,3,0.09699999999999999,2,RW/LW,2013,2015
Daniel Chicoine,31,1,2,3,0.09699999999999999,12,RW,1977,1980
Kent McDonell,32,1,2,3,0.094,36,RW,2002,2004
Darryl Bootland,32,1,2,3,0.094,85,RW,2003,2008
Larry Courville,33,1,2,3,0.091,16,LW,1995,1998
Roger Lemelin,36,1,2,3,0.083,27,D,1974,1978
Barry Cummins,36,1,2,3,0.083,39,D,1973,1974
Garrett Burnett,39,1,2,3,0.077,184,LW,2003,2004
Gerry Goyer,40,1,2,3,0.075,4,C,1967,1968
Maxim Kondratyev,40,1,2,3,0.075,24,D,2003,2008
Kenndal McArdle,42,1,2,3,0.071,51,LW,2008,2012
Shane Endicott,45,1,2,3,0.067,47,C,2001,2006
Matt Higgins,57,1,2,3,0.053,6,C,1997,2001
Jay Leach,70,1,2,3,0.043,60,D,2005,2011
Darryl Sly,79,1,2,3,0.038,20,D,1965,1971
Dennis Bonvie,92,1,2,3,0.033,311,RW,1994,2004
Patrick Cote,105,1,2,3,0.028999999999999998,377,LW,1995,2001
Risto Jalo,3,0,3,3,1.0,0,C,1985,1986
Bill Kyle,3,0,3,3,1.0,0,C,1949,1951
Paul Miller,3,0,3,3,1.0,0,C,1981,1982
Joe Crozier,5,0,3,3,0.6,2,D,1959,1960
Les Auge,6,0,3,3,0.5,4,D,1980,1981
Ron Busniuk,6,0,3,3,0.5,13,C,1972,1974
Scott Kosmachuk,8,0,3,3,0.375,2,RW,2015,2016
Stan Smrke,9,0,3,3,0.33299999999999996,0,LW,1956,1958
Patrick Wey,9,0,3,3,0.33299999999999996,5,D,2013,2014
Jan Benda,9,0,3,3,0.33299999999999996,6,C/D,1997,1998
Chad Billins,10,0,3,3,0.3,0,D,2013,2014
Roland McKeown,10,0,3,3,0.3,19,D,2017,2018
Stuart Percy,12,0,3,3,0.25,2,D,2014,2016
Ron Handy,14,0,3,3,0.214,0,C,1984,1988
Jacob Middleton,14,0,3,3,0.214,13,D,2018,2021
Don Gibson,14,0,3,3,0.214,20,D,1990,1991
Paul Pooley,15,0,3,3,0.2,0,F,1984,1986
Joseph Gambardella,15,0,3,3,0.2,2,C/LW,2018,2019
Vladimir Mihalik,15,0,3,3,0.2,8,D,2008,2010
Richard Petiot,15,0,3,3,0.2,25,D,2005,2011
Rob Palmer,16,0,3,3,0.188,2,C,1973,1976
Jacques Lemieux,16,0,3,3,0.188,8,D,1967,1969
Timo Parssinen,17,0,3,3,0.17600000000000002,2,LW/RW,2001,2002
Brett Bulmer,17,0,3,3,0.17600000000000002,15,RW/LW,2011,2016
Joel Prpic,18,0,3,3,0.16699999999999998,4,C,1997,2001
Murdo MacKay,19,0,3,3,0.158,0,RW,1945,1949
Larry Bignell,20,0,3,3,0.15,2,D,1973,1975
Julien Gauthier,20,0,3,3,0.15,8,RW,2019,2021
Connie Madigan,20,0,3,3,0.15,25,D,1972,1973
Greg Pankewicz,21,0,3,3,0.14300000000000002,22,RW,1993,1999
Robert Schnabel,22,0,3,3,0.136,34,D,2001,2004
Ashton Sautner,23,0,3,3,0.13,4,D,2017,2020
Mario Giallonardo,23,0,3,3,0.13,6,D,1979,1981
Tim Friday,23,0,3,3,0.13,6,D,1985,1986
Gabriel Carlsson,23,0,3,3,0.13,8,D,2016,2021
Karl Stollery,23,0,3,3,0.13,21,D,2013,2017
Marek Hrivik,24,0,3,3,0.125,2,C/LW,2015,2018
Leo Quenneville,25,0,3,3,0.12,10,LW,1929,1930
Gregory Tebbutt,26,0,3,3,0.115,35,D,1979,1984
Anssi Melametsa,27,0,3,3,0.111,2,C,1985,1986
Eddie Panagabko,29,0,3,3,0.10300000000000001,38,LW,1955,1957
Andrei Bashkirov,30,0,3,3,0.1,0,LW,1998,2001
Norman Mann,31,0,3,3,0.09699999999999999,4,RW,1935,1941
Hugh Coflin,31,0,3,3,0.09699999999999999,33,D,1950,1951
Boyd Kane,31,0,3,3,0.09699999999999999,39,LW/C,2003,2010
Jim Warner,32,0,3,3,0.094,10,RW,1979,1980
Rob O'Gara,33,0,3,3,0.091,6,D,2016,2018
Andreas Englund,33,0,3,3,0.091,24,D,2016,2020
Oleg Mikulchik,37,0,3,3,0.081,33,D,1993,1996
Jim Krulicki,41,0,3,3,0.073,6,RW,1970,1971
Larry McIntyre,41,0,3,3,0.073,26,D,1969,1973
Pierre-Luc Letourneau-Leblond,41,0,3,3,0.073,101,LW/RW,2008,2014
Sergei Plotnikov,45,0,3,3,0.067,24,LW/RW,2015,2016
Danny Richmond,49,0,3,3,0.061,75,D,2005,2008
Bobby Allen,51,0,3,3,0.059000000000000004,12,D,2002,2008
Chris Ahrens,52,0,3,3,0.057999999999999996,84,D,1972,1978
Carter Ashton,54,0,3,3,0.055999999999999994,32,RW/LW,2011,2015
Patrick Sieloff,2,2,0,2,1.0,2,D,2015,2018
Spencer Foo,4,2,0,2,0.5,0,RW,2017,2018
Dan Belisle,4,2,0,2,0.5,0,RW,1960,1961
Dan Woodley,5,2,0,2,0.4,17,C,1987,1988
Dick Butler,7,2,0,2,0.28600000000000003,0,RW,1947,1948
Alex Grant,7,2,0,2,0.28600000000000003,9,D,2013,2016
Gord Brydson,8,2,0,2,0.25,8,C,1929,1930
Chad Rau,9,2,0,2,0.222,0,C/LW,2011,2012
Del Hall,9,2,0,2,0.222,2,C,1971,1974
Martin Spanhel,10,2,0,2,0.2,4,LW,2000,2002
Peter Bakovic,10,2,0,2,0.2,48,LW,1987,1988
Steve Nemeth,12,2,0,2,0.16699999999999998,2,RW,1987,1988
Don Biggs,12,2,0,2,0.16699999999999998,8,C,1984,1990
Pat Micheletti,12,2,0,2,0.16699999999999998,8,C,1987,1988
Gerry Mayhew,13,2,0,2,0.154,2,C/RW,2019,2020
Cecil Browne,13,2,0,2,0.154,4,LW,1927,1928
Bob Francis,14,2,0,2,0.14300000000000002,0,C,1982,1983
Jon Matsumoto,14,2,0,2,0.14300000000000002,4,C,2010,2012
Mike Walsh,14,2,0,2,0.14300000000000002,4,C,1987,1989
Pat Kavanagh,14,2,0,2,0.14300000000000002,6,RW,2000,2006
Mike Angelidis,14,2,0,2,0.14300000000000002,22,LW/C,2011,2016
John Holota,15,2,0,2,0.133,0,C,1942,1946
David Kelly,16,2,0,2,0.125,4,RW,1976,1977
Jack Coughlin,20,2,0,2,0.1,3,RW,1917,1921
Logan O'Connor,21,2,0,2,0.095,2,RW,2018,2020
Paul Stewart,21,2,0,2,0.095,74,RW,1979,1980
Cody Almond,25,2,0,2,0.08,26,C,2009,2012
Normand Baron,27,2,0,2,0.07400000000000001,51,F,1983,1986
Glen Sonmor,28,2,0,2,0.071,21,LW,1953,1955
Leo Lafrance,33,2,0,2,0.061,6,LW/C,1926,1928
Yanick Dupre,35,2,0,2,0.057,16,LW,1991,1996
Luc Bourdon,36,2,0,2,0.055999999999999994,24,D,2006,2008
Jack Pratt,37,2,0,2,0.054000000000000006,42,C,1930,1932
Ryan Russell,41,2,0,2,0.049,2,LW/RW,2011,2012
Fred Elliott,43,2,0,2,0.047,6,RW,1928,1929
Damian Surma,2,1,1,2,1.0,0,C/LW,2002,2004
Randy MacGregor,2,1,1,2,1.0,2,LW,1981,1982
Wayne Smith,2,1,1,2,1.0,2,D,1966,1967
Lee Sweatt,3,1,1,2,0.667,2,D,2010,2011
Daniel Poulin,3,1,1,2,0.667,2,D,1981,1982
Jordan Smotherman,4,1,1,2,0.5,0,LW/RW,2007,2009
Justin Florek,4,1,1,2,0.5,0,C/W,2013,2014
Dallas Gaume,4,1,1,2,0.5,0,C,1988,1989
Norman Lowe,4,1,1,2,0.5,0,F,1949,1950
Ted Speers,4,1,1,2,0.5,0,C,1985,1986
Yegor Sharangovich,4,1,1,2,0.5,0,C,2020,2021
Dan Dorion,4,1,1,2,0.5,2,RW,1985,1988
Todd McLellan,5,1,1,2,0.4,0,C,1987,1988
Jim Haggarty,5,1,1,2,0.4,0,LW,1941,1942
Dylan Cozens,5,1,1,2,0.4,0,C/RW,2020,2021
Jack Studnicka,5,1,1,2,0.4,2,C/RW,2019,2021
Alexander Romanov,5,1,1,2,0.4,2,D,2020,2021
Matthieu Descoteaux,5,1,1,2,0.4,4,D,2000,2001
Nick Merkley,5,1,1,2,0.4,4,RW/C,2017,2021
Ernie Godden,5,1,1,2,0.4,6,C,1981,1982
Tony Martensson,6,1,1,2,0.33299999999999996,0,C,2003,2004
Simon Moser,6,1,1,2,0.33299999999999996,2,C/W,2013,2014
Ken Stewart,6,1,1,2,0.33299999999999996,2,D,1941,1942
Brian McKenzie,6,1,1,2,0.33299999999999996,4,C,1971,1972
Nils Hoglander,6,1,1,2,0.33299999999999996,4,LW,2020,2021
Bobby Reynolds,7,1,1,2,0.28600000000000003,0,RW,1989,1990
Eeli Tolvanen,7,1,1,2,0.28600000000000003,0,LW/RW,2017,2021
Gary Veneruzzo,7,1,1,2,0.28600000000000003,0,LW,1967,1972
David McIntyre,7,1,1,2,0.28600000000000003,2,C/W,2011,2012
Norm Armstrong,7,1,1,2,0.28600000000000003,2,RW,1962,1963
Carl Smith,7,1,1,2,0.28600000000000003,2,RW,1943,1944
Ross Yates,7,1,1,2,0.28600000000000003,4,C,1983,1984
Kael Mouillierat,7,1,1,2,0.28600000000000003,10,C/LW,2014,2016
Rob Collins,8,1,1,2,0.25,0,RW/C,2005,2006
Joe Levandoski,8,1,1,2,0.25,0,D,1946,1947
John Newman,8,1,1,2,0.25,0,C,1930,1931
Frank Sheppard,8,1,1,2,0.25,0,C/LW,1927,1928
Drew Fata,8,1,1,2,0.25,9,D,2006,2008
Tyler Lewington,8,1,1,2,0.25,24,D,2018,2020
Justin Mercier,9,1,1,2,0.222,0,C,2009,2010
Garry Swain,9,1,1,2,0.222,0,C,1968,1969
Lubomir Vaic,9,1,1,2,0.222,2,LW/C,1997,2000
Chad Wiseman,9,1,1,2,0.222,8,LW,2002,2006
Pat Neaton,9,1,1,2,0.222,12,D,1993,1994
Mark Morrison,10,1,1,2,0.2,0,C,1981,1984
Richard Grenier,10,1,1,2,0.2,2,C,1972,1973
Mikey Anderson,10,1,1,2,0.2,2,D,2019,2021
Stu McNeill,10,1,1,2,0.2,2,C,1957,1960
Mickey Blake,10,1,1,2,0.2,4,LW,1932,1936
Bob Warner,10,1,1,2,0.2,4,D/RW,1975,1977
Cole Bardreau,10,1,1,2,0.2,6,C,2019,2020
Bob Stumpf,10,1,1,2,0.2,20,D,1974,1975
Phil Oreskovic,10,1,1,2,0.2,21,D,2008,2009
Tord Lundstrom,11,1,1,2,0.182,0,LW,1973,1974
Julien Brouillette,11,1,1,2,0.182,0,D,2013,2015
Don Smith,11,1,1,2,0.182,0,C,1949,1950
Barry Tallackson,11,1,1,2,0.182,2,RW,2005,2009
Ronald Smith,11,1,1,2,0.182,14,D,1972,1973
Ray Ceresino,12,1,1,2,0.16699999999999998,2,LW,1948,1949
Gord Kuhn,12,1,1,2,0.16699999999999998,4,RW,1932,1933
Joey Hishon,13,1,1,2,0.154,0,C,2013,2015
Morris Stefaniw,13,1,1,2,0.154,2,C,1972,1973
Nick Caamano,13,1,1,2,0.154,4,RW/LW,2019,2021
Gary Dillon,13,1,1,2,0.154,29,C,1980,1981
Lloyd Jackson,14,1,1,2,0.14300000000000002,0,C,1936,1937
Ray Markham,14,1,1,2,0.14300000000000002,21,RW,1979,1980
Jack Tomson,15,1,1,2,0.133,0,D,1938,1941
Wade Megan,15,1,1,2,0.133,2,C,2016,2019
Eddie Finnigan,15,1,1,2,0.133,2,LW,1934,1936
Borna Rendulic,15,1,1,2,0.133,6,RW,2014,2017
Jason Akeson,15,1,1,2,0.133,8,RW,2012,2015
Bjorn Johansson,15,1,1,2,0.133,10,D,1976,1978
Tuomas Pihlman,15,1,1,2,0.133,12,LW/RW,2003,2007
Rick Bennett,15,1,1,2,0.133,13,LW/C/D,1989,1992
Matt Elich,16,1,1,2,0.125,0,RW,1999,2001
Corey Spring,16,1,1,2,0.125,12,RW,1997,1999
Liam O'Brien,17,1,1,2,0.11800000000000001,28,C/LW,2014,2018
Hugh Harvey,18,1,1,2,0.111,4,C/LW,1974,1976
Brian Hill,19,1,1,2,0.105,4,RW,1979,1980
Al Huggins,20,1,1,2,0.1,2,LW,1930,1931
Tom Thurlby,20,1,1,2,0.1,4,D,1967,1968
Gord Wappel,20,1,1,2,0.1,10,D,1979,1982
Duncan Siemens,20,1,1,2,0.1,25,D,2014,2018
Marc Rodgers,21,1,1,2,0.095,10,RW,1999,2000
Zenith Komarniski,21,1,1,2,0.095,10,D,1999,2004
Toni Dahlman,22,1,1,2,0.091,0,RW,2001,2003
Connor Bunnaman,22,1,1,2,0.091,2,C/LW,2019,2021
James Bedard,22,1,1,2,0.091,8,D,1949,1951
Mike Wong,22,1,1,2,0.091,12,C,1975,1976
Dudley Garrett,23,1,1,2,0.087,18,D,1942,1943
Frank Beaton,25,1,1,2,0.08,43,RW,1978,1980
Craig Ferguson,27,1,1,2,0.07400000000000001,6,C,1993,2000
Bill Phillips,27,1,1,2,0.07400000000000001,6,C,1929,1930
Jeremy Welsh,27,1,1,2,0.07400000000000001,12,C/LW,2011,2016
Anton Blidh,28,1,1,2,0.071,7,LW/RW,2016,2020
Antti-Jussi Niemi,29,1,1,2,0.069,22,D,2000,2002
Alexei Tezikov,30,1,1,2,0.067,2,D,1998,2002
Peter Ratchuk,32,1,1,2,0.063,10,D,1998,2001
Christian Dube,33,1,1,2,0.061,4,C,1996,1999
Dave Hanson,33,1,1,2,0.061,65,D,1978,1980
Brad Mills,34,1,1,2,0.059000000000000004,37,C/RW,2010,2014
Amby Moran,35,1,1,2,0.057,24,D,1926,1928
Lionel Heinrich,35,1,1,2,0.057,33,LW,1955,1956
Eddie Convey,36,1,1,2,0.055999999999999994,33,LW,1930,1933
Ron Moffat,37,1,1,2,0.054000000000000006,8,LW,1932,1935
D.J. Smith,45,1,1,2,0.044000000000000004,67,D,1996,2003
Rob Globke,46,1,1,2,0.043,8,RW,2005,2008
Erik Reitz,48,1,1,2,0.042,69,D,2005,2009
Fred Lowrey,53,1,1,2,0.038,10,F,1924,1926
Ganton Scott,57,1,1,2,0.035,0,RW,1922,1925
John Hilworth,57,1,1,2,0.035,89,D,1977,1980
Al Tuer,57,1,1,2,0.035,208,D,1985,1990
Kip Brennan,61,1,1,2,0.033,222,LW,2001,2008
Petr Straka,3,0,2,2,0.667,0,LW,2014,2015
Louie Belpedio,3,0,2,2,0.667,0,D,2017,2021
Jonas Nordqvist,3,0,2,2,0.667,2,C,2006,2007
Karel Betik,3,0,2,2,0.667,2,D,1998,1999
Anatoli Fedotov,4,0,2,2,0.5,0,D,1992,1994
Viktor Loov,4,0,2,2,0.5,0,D,2015,2016
Sergei Tolchinsky,4,0,2,2,0.5,0,LW/RW,2015,2017
Rick Chinnick,4,0,2,2,0.5,0,RW,1973,1975
Sherman White,4,0,2,2,0.5,0,C,1946,1950
Ted McCaskill,4,0,2,2,0.5,0,C,1967,1968
Jonas Junland,4,0,2,2,0.5,2,D,2008,2010
David Musil,4,0,2,2,0.5,2,D,2014,2015
Shawn Rivers,4,0,2,2,0.5,2,D,1992,1993
Chuck Hamilton,4,0,2,2,0.5,2,LW,1961,1973
Gerry Brisson,4,0,2,2,0.5,4,RW,1962,1963
Daniel Brickley,5,0,2,2,0.4,0,D,2017,2019
John Leonard,5,0,2,2,0.4,0,LW,2020,2021
Ivan Vishnevsky,5,0,2,2,0.4,2,D,2008,2010
Rejean Cloutier,5,0,2,2,0.4,2,D,1979,1982
Lorrain Thibeault,5,0,2,2,0.4,2,LW,1944,1946
Tomas Kana,6,0,2,2,0.33299999999999996,2,RW/C,2009,2010
Mike Zalewski,6,0,2,2,0.33299999999999996,2,C/LW,2013,2017
Tobias Lindberg,6,0,2,2,0.33299999999999996,4,RW/LW,2015,2016
Al LeBrun,6,0,2,2,0.33299999999999996,4,D,1960,1966
Doug Buhr,6,0,2,2,0.33299999999999996,4,LW,1974,1975
Garrett Stafford,7,0,2,2,0.28600000000000003,0,D,2007,2011
Chris Kenady,7,0,2,2,0.28600000000000003,0,RW,1997,2000
Liam Foudy,7,0,2,2,0.28600000000000003,0,C/W,2019,2021
Mike Richard,7,0,2,2,0.28600000000000003,2,C,1987,1990
Roger Wilson,7,0,2,2,0.28600000000000003,6,D,1974,1975
Daniel Bang,8,0,2,2,0.25,0,LW/RW,2012,2013
Ryan Jardine,8,0,2,2,0.25,2,LW,2001,2002
Martin Desjardins,8,0,2,2,0.25,2,F,1989,1990
Shaun Heshka,8,0,2,2,0.25,4,D,2009,2010
Charlie Stephens,8,0,2,2,0.25,4,C/RW,2002,2004
Gerard Desaulniers,8,0,2,2,0.25,4,C,1950,1954
Lars Jonsson,8,0,2,2,0.25,6,D,2006,2007
Brian Young,8,0,2,2,0.25,6,D,1980,1981
Michael Funk,9,0,2,2,0.222,0,D,2006,2008
Markku Kyllonen,9,0,2,2,0.222,2,F,1988,1989
Tom Dewar,9,0,2,2,0.222,4,D,1943,1944
Chris Breen,9,0,2,2,0.222,5,D,2013,2014
Bill Bowler,9,0,2,2,0.222,8,C,2000,2001
Jim Riley,9,0,2,2,0.222,14,LW,1926,1927
Danny Biega,10,0,2,2,0.2,0,D,2014,2015
Marcel Tremblay,10,0,2,2,0.2,0,RW,1938,1939
Jean-Paul Denis,10,0,2,2,0.2,2,RW,1946,1950
Chris Schmidt,10,0,2,2,0.2,5,D,2002,2003
Jergus Baca,10,0,2,2,0.2,14,D,1990,1992
Alex Plante,10,0,2,2,0.2,15,D,2009,2012
Ken Baird,10,0,2,2,0.2,15,D,1971,1972
Ilya Zubov,11,0,2,2,0.182,0,C,2007,2009
Glen Burdon,11,0,2,2,0.182,0,D,1974,1975
Jeff Farkas,11,0,2,2,0.182,6,C,1999,2003
Art Alexandre,11,0,2,2,0.182,8,LW,1931,1933
Jiri Sejba,11,0,2,2,0.182,8,LW,1990,1991
Dillon Heatherington,11,0,2,2,0.182,26,D,2017,2019
Nico Sturm,12,0,2,2,0.16699999999999998,0,C,2018,2021
Randy Legge,12,0,2,2,0.16699999999999998,2,D,1972,1973
Andrew MacWilliam,12,0,2,2,0.16699999999999998,12,D,2014,2015
Jaroslav Sevcik,13,0,2,2,0.154,2,RW,1989,1990
Joel Persson,13,0,2,2,0.154,2,D,2019,2020
Dennis Abgrall,13,0,2,2,0.154,4,RW,1975,1976
Jyrki Seppa,13,0,2,2,0.154,6,D,1983,1984
Lorry Gloeckner,13,0,2,2,0.154,6,D,1978,1979
Danick Martel,13,0,2,2,0.154,8,LW,2017,2019
Peter Dineen,13,0,2,2,0.154,13,D,1986,1990
Kevin Czuczman,13,0,2,2,0.154,14,D,2013,2021
Mike Bishai,14,0,2,2,0.14300000000000002,19,C,2003,2004
John Taft,15,0,2,2,0.133,4,D,1978,1979
Walter Ledingham,15,0,2,2,0.133,4,LW,1972,1977
Arturs Kulda,15,0,2,2,0.133,8,D,2009,2012
Simon Wheeldon,15,0,2,2,0.133,10,LW,1987,1991
Andy Miele,15,0,2,2,0.133,11,C,2011,2014
Marquis Mathieu,16,0,2,2,0.125,14,RW,1998,2001
John Bethel,17,0,2,2,0.11800000000000001,4,LW,1979,1980
Ed Reigle,17,0,2,2,0.11800000000000001,25,D,1950,1951
Arch Wilder,18,0,2,2,0.111,2,LW,1940,1941
Fyodor Fyodorov,18,0,2,2,0.111,14,LW/C,2002,2006
Selmar Odelein,18,0,2,2,0.111,35,D,1985,1989
Mike Duco,18,0,2,2,0.111,65,W/C,2009,2012
Tom Polanic,19,0,2,2,0.105,53,D,1969,1971
Mitch Messier,20,0,2,2,0.1,11,RW,1987,1991
Stefan Meyer,20,0,2,2,0.1,17,LW,2007,2011
Joel Baillargeon,20,0,2,2,0.1,31,LW,1986,1989
Sean Whyte,21,0,2,2,0.095,12,RW,1991,1993
Jordan Krestanovich,22,0,2,2,0.091,0,C,2001,2004
Zach Whitecloud,22,0,2,2,0.091,4,D,2017,2021
Brian O'Neill,22,0,2,2,0.091,8,RW/LW,2015,2016
Armand Raymond,22,0,2,2,0.091,10,D,1937,1940
Dean DeFazio,22,0,2,2,0.091,28,LW,1983,1984
Jan Mertzig,23,0,2,2,0.087,8,D,1998,1999
Rhys Thomson,25,0,2,2,0.08,38,D,1939,1943
Keith Hanson,25,0,2,2,0.08,77,D,1983,1984
Mike Rucinski,26,0,2,2,0.077,10,D,1997,2001
Neil LaBatte,26,0,2,2,0.077,19,D,1978,1982
Darcy Regier,26,0,2,2,0.077,35,D,1977,1984
Randy Osburn,27,0,2,2,0.07400000000000001,0,LW,1972,1975
Shayne Stevenson,27,0,2,2,0.07400000000000001,35,RW/C,1990,1993
Ted Fauss,28,0,2,2,0.071,15,D,1986,1988
Tom Price,29,0,2,2,0.069,12,D,1974,1979
Jim Niekamp,29,0,2,2,0.069,37,D,1970,1972
Julian Melchiori,30,0,2,2,0.067,8,D,2013,2017
Jim Murray,30,0,2,2,0.067,14,D,1967,1968
Mike Stothers,30,0,2,2,0.067,65,D,1984,1988
Andre Deveaux,31,0,2,2,0.065,104,RW/C,2008,2012
Bob Whitelaw,32,0,2,2,0.063,2,D,1940,1942
Rene Chapdelaine,32,0,2,2,0.063,32,D,1990,1993
Steve Gainey,33,0,2,2,0.061,34,LW,2000,2006
Michal Barinka,34,0,2,2,0.059000000000000004,26,D,2003,2006
Jaime Sifers,37,0,2,2,0.054000000000000006,24,D,2008,2010
Griffin Reinhart,37,0,2,2,0.054000000000000006,26,D,2014,2017
Darcy Verot,37,0,2,2,0.054000000000000006,135,LW,2003,2004
Kerry Ketter,41,0,2,2,0.049,58,D,1972,1973
John Mokosak,41,0,2,2,0.049,96,D,1988,1990
Andrew Campbell,42,0,2,2,0.048,12,D,2013,2016
Beattie Ramsay,43,0,2,2,0.047,10,D,1927,1928
Cummy Burton,43,0,2,2,0.047,21,RW,1955,1959
Petter Granberg,45,0,2,2,0.044000000000000004,29,D,2013,2017
Tomas Malec,46,0,2,2,0.043,47,D,2002,2007
Paul McIntosh,48,0,2,2,0.042,66,D,1974,1976
John Gibson,48,0,2,2,0.042,120,D,1980,1984
Jesse Wallin,49,0,2,2,0.040999999999999995,34,D,1999,2003
Ben Ondrus,52,0,2,2,0.038,72,RW,2005,2009
Matthew Spiller,68,0,2,2,0.028999999999999998,74,D,2003,2008
Brad Fast,1,1,0,1,1.0,0,D,2003,2004
Yegor Korshkov,1,1,0,1,1.0,0,RW,2019,2020
Roland Huard,1,1,0,1,1.0,0,C,1930,1931
Samuel Henley,1,1,0,1,1.0,2,C/LW,2016,2017
Dean Morton,1,1,0,1,1.0,2,D,1989,1990
Adam Almquist,2,1,0,1,0.5,0,D,2013,2014
Jacob MacDonald,2,1,0,1,0.5,0,D,2018,2019
Tony Joseph,2,1,0,1,0.5,0,F,1988,1989
Hickey Nicholson,2,1,0,1,0.5,0,LW,1937,1938
George Grigor,2,1,0,1,0.5,0,C,1943,1944
Bernie Ruelle,2,1,0,1,0.5,0,LW,1943,1944
Matt Carey,2,1,0,1,0.5,2,W/C,2013,2014
Tim Stutzle,2,1,0,1,0.5,2,C/LW,2020,2021
Bjorn Melin,3,1,0,1,0.33299999999999996,0,RW,2006,2007
Carter Camper,3,1,0,1,0.33299999999999996,0,C/RW,2011,2012
Yevgeni Shaldybin,3,1,0,1,0.33299999999999996,0,D,1996,1997
Corey Elkins,3,1,0,1,0.33299999999999996,0,C,2009,2010
Gary Emmons,3,1,0,1,0.33299999999999996,0,C,1993,1994
Ryan Stewart,3,1,0,1,0.33299999999999996,0,C,1985,1986
Viktor Nechayev,3,1,0,1,0.33299999999999996,0,C,1982,1983
Kelly Burnett,3,1,0,1,0.33299999999999996,0,C,1952,1953
Pete Leswick,3,1,0,1,0.33299999999999996,0,RW,1936,1945
Maxim Letunov,3,1,0,1,0.33299999999999996,0,C,2019,2020
Petteri Wirtanen,3,1,0,1,0.33299999999999996,2,C,2007,2008
Vadim Shipachyov,3,1,0,1,0.33299999999999996,2,C,2017,2018
Todd Nelson,3,1,0,1,0.33299999999999996,2,D,1991,1994
Vitali Abramov,3,1,0,1,0.33299999999999996,2,LW/RW,2018,2020
Travis Turnbull,3,1,0,1,0.33299999999999996,5,C/RW,2011,2012
Ralph Keller,3,1,0,1,0.33299999999999996,6,D,1962,1963
Roy Sommer,3,1,0,1,0.33299999999999996,7,C,1980,1981
Art Ross,3,1,0,1,0.33299999999999996,12,D,1917,1918
Jari Torkki,4,1,0,1,0.25,0,RW/LW,1988,1989
Kurtis McLean,4,1,0,1,0.25,0,C,2008,2009
Kevin Henderson,4,1,0,1,0.25,0,LW/C,2012,2013
Igor Vyazmikin,4,1,0,1,0.25,0,RW,1990,1991
Bill Sweeney,4,1,0,1,0.25,0,C,1959,1960
Adolph Kukulowicz,4,1,0,1,0.25,0,C,1952,1954
Bobby Rowe,4,1,0,1,0.25,0,F,1924,1925
Lloyd Cook,4,1,0,1,0.25,0,D,1924,1925
Larry Fullan,4,1,0,1,0.25,0,LW,1974,1975
Blake Hillman,4,1,0,1,0.25,0,D,2017,2018
Philipp Kurashev,4,1,0,1,0.25,0,C/LW,2020,2021
Klim Kostin,4,1,0,1,0.25,0,LW/RW,2019,2020
Doug Horbul,4,1,0,1,0.25,2,LW,1974,1975
Hank Damore,4,1,0,1,0.25,2,C,1943,1944
Brady Murray,4,1,0,1,0.25,6,C/W,2007,2008
Tomas Divisek,5,1,0,1,0.2,0,C,2000,2002
Mark Beaufait,5,1,0,1,0.2,0,C,1992,1993
Josh Olson,5,1,0,1,0.2,0,LW,2003,2004
Joe Whitney,5,1,0,1,0.2,0,LW/RW,2013,2015
Brian Carlin,5,1,0,1,0.2,0,LW,1971,1972
Ronnie Rowe,5,1,0,1,0.2,0,LW,1947,1948
Bob Fryday,5,1,0,1,0.2,0,RW,1949,1952
Justin Hodgman,5,1,0,1,0.2,2,C,2014,2015
Robert LaForest,5,1,0,1,0.2,2,RW,1983,1984
Dick Behling,5,1,0,1,0.2,2,D,1940,1943
Michael Bunting,5,1,0,1,0.2,2,LW/RW,2018,2019
Jim Ennis,5,1,0,1,0.2,10,D,1987,1988
Steve Coates,5,1,0,1,0.2,24,RW,1976,1977
Mario Bliznak,6,1,0,1,0.16699999999999998,0,C,2009,2011
Jeff McLean,6,1,0,1,0.16699999999999998,0,C,1993,1994
Dan Lucas,6,1,0,1,0.16699999999999998,0,RW,1978,1979
David Kase,6,1,0,1,0.16699999999999998,0,RW/LW,2019,2020
Bernie Morris,6,1,0,1,0.16699999999999998,0,F,1924,1925
Grant Erickson,6,1,0,1,0.16699999999999998,0,RW,1968,1970
Petr Hubacek,6,1,0,1,0.16699999999999998,2,LW/RW,2000,2001
Joe Jensen,6,1,0,1,0.16699999999999998,2,C/LW,2007,2008
Sandy Beadle,6,1,0,1,0.16699999999999998,2,LW,1980,1981
Lyle Bradley,6,1,0,1,0.16699999999999998,2,C/RW,1973,1977
Jarod Palmer,6,1,0,1,0.16699999999999998,4,RW,2011,2012
Herb Foster,6,1,0,1,0.16699999999999998,5,LW,1940,1948
Mike Moore,6,1,0,1,0.16699999999999998,7,D,2010,2011
Pierre-Yves Giroux,6,1,0,1,0.16699999999999998,17,LW,1982,1983
Rod Dallman,6,1,0,1,0.16699999999999998,26,LW,1987,1992
John Purves,7,1,0,1,0.14300000000000002,0,RW,1990,1991
Lukas Vejdemo,7,1,0,1,0.14300000000000002,0,C/LW,2019,2020
Bob Charlebois,7,1,0,1,0.14300000000000002,0,LW,1967,1968
Brian Tutt,7,1,0,1,0.14300000000000002,2,D,1989,1990
Jonathan Ferland,7,1,0,1,0.14300000000000002,2,RW,2005,2006
Peter Sarno,7,1,0,1,0.14300000000000002,2,C,2003,2006
Mike Siltala,7,1,0,1,0.14300000000000002,2,RW,1981,1988
Clarence Schmidt,7,1,0,1,0.14300000000000002,2,RW,1943,1944
Evan Bouchard,7,1,0,1,0.14300000000000002,2,D,2018,2019
Jan Nemecek,7,1,0,1,0.14300000000000002,4,D,1998,2000
Dan Gratton,7,1,0,1,0.14300000000000002,5,C,1987,1988
David Liffiton,7,1,0,1,0.14300000000000002,26,D,2005,2011
Bryan Lerg,8,1,0,1,0.125,0,LW/C,2014,2016
Sergei Shirokov,8,1,0,1,0.125,2,LW/RW,2009,2011
Andrej Podkonicky,8,1,0,1,0.125,2,LW/C,2000,2004
Anthony Angello,8,1,0,1,0.125,4,C/RW,2019,2020
Nelson Burton,8,1,0,1,0.125,21,LW,1977,1979
Rob Skrlac,8,1,0,1,0.125,22,LW,2003,2004
Patrick Davis,9,1,0,1,0.111,0,RW/C,2008,2010
John Albert,9,1,0,1,0.111,0,C,2013,2014
Owen Tippett,9,1,0,1,0.111,0,RW/LW,2017,2021
Shawn Evans,9,1,0,1,0.111,2,D,1985,1990
Alvin Fisher,9,1,0,1,0.111,4,RW,1924,1925
Shawn McCosh,9,1,0,1,0.111,6,C,1991,1995
Kellan Lain,9,1,0,1,0.111,21,LW/C,2013,2014
Petr Kanko,10,1,0,1,0.1,0,RW,2005,2006
Pat Shea,10,1,0,1,0.1,0,D,1931,1932
Frank King,10,1,0,1,0.1,2,C,1950,1951
Howard McNamara,10,1,0,1,0.1,4,D,1919,1920
John Persson,10,1,0,1,0.1,6,LW/RW,2013,2014
Jani Hakanpaa,10,1,0,1,0.1,6,D,2019,2021
Brent Tremblay,10,1,0,1,0.1,6,D,1978,1980
Alex Formenton,10,1,0,1,0.1,6,LW,2017,2019
Raymond Sawada,11,1,0,1,0.091,0,RW,2008,2011
Bobby Boucher,11,1,0,1,0.091,0,C,1923,1924
Greg Rallo,11,1,0,1,0.091,2,C,2011,2013
Doug Macdonald,11,1,0,1,0.091,2,LW,1992,1995
Jimmy Creighton,11,1,0,1,0.091,2,LW,1930,1931
Tim Armstrong,11,1,0,1,0.091,6,C,1988,1989
Stephane Roy,12,1,0,1,0.083,0,C,1987,1988
Charlie Cotch,12,1,0,1,0.083,0,LW,1924,1925
Les Kozak,12,1,0,1,0.083,2,LW,1961,1962
Carl Klingberg,12,1,0,1,0.083,4,RW,2010,2015
Bill McCreary Jr.,12,1,0,1,0.083,4,RW,1980,1981
Patrick Daley,12,1,0,1,0.083,13,LW,1979,1981
Keith Redmond,12,1,0,1,0.083,20,LW,1993,1994
Casey Bailey,13,1,0,1,0.077,2,RW/C,2014,2017
Rourke Chartier,13,1,0,1,0.077,2,C,2018,2019
John Sleaver,13,1,0,1,0.077,6,C,1953,1957
Marc Dufour,14,1,0,1,0.071,2,RW,1963,1969
Kyle Capobianco,14,1,0,1,0.071,4,D,2017,2021
Dane Byers,14,1,0,1,0.071,60,LW/RW,2007,2012
Carsen Twarynski,15,1,0,1,0.067,4,LW,2019,2021
Petr Vrana,16,1,0,1,0.063,2,C,2008,2009
Connor James,16,1,0,1,0.063,2,C,2005,2009
Kris Vernarsky,17,1,0,1,0.059000000000000004,2,C,2002,2004
Russ Walker,17,1,0,1,0.059000000000000004,41,RW,1976,1978
Alexander Suglobov,18,1,0,1,0.055999999999999994,4,RW,2003,2007
Martin Grenier,18,1,0,1,0.055999999999999994,14,D,2001,2007
Fred Brown,19,1,0,1,0.053,0,LW,1927,1928
Eriah Hayes,19,1,0,1,0.053,4,RW,2013,2015
Howie Mackie,20,1,0,1,0.05,4,RW,1936,1938
Bobby Burns,20,1,0,1,0.05,8,LW,1927,1930
Mike McHugh,20,1,0,1,0.05,16,LW,1988,1992
Mike Halmo,20,1,0,1,0.05,32,LW/RW,2013,2014
Chris McRae,21,1,0,1,0.048,122,LW,1987,1990
David Gustafsson,22,1,0,1,0.045,0,C,2019,2021
Josh Hennessy,23,1,0,1,0.043,6,C,2006,2012
Claude Robert,23,1,0,1,0.043,9,LW,1950,1951
Ben Walter,24,1,0,1,0.042,6,C,2005,2010
Scott Timmins,24,1,0,1,0.042,12,C,2010,2013
Phil Stevens,25,1,0,1,0.04,2,C,1917,1926
Alexei Kudashov,25,1,0,1,0.04,4,C,1993,1994
Jake Dyte,27,1,0,1,0.037000000000000005,31,D,1943,1944
Ryan Flinn,31,1,0,1,0.032,84,LW,2001,2006
Fred Robertson,34,1,0,1,0.028999999999999998,35,D,1931,1934
Gerald Munro,34,1,0,1,0.028999999999999998,37,D,1924,1926
Dean Turner,35,1,0,1,0.028999999999999998,59,D,1978,1983
Reg Reid,39,1,0,1,0.026000000000000002,4,LW,1924,1926
Cale Fleury,41,1,0,1,0.024,6,D,2019,2021
Harry Helman,44,1,0,1,0.023,7,RW,1922,1925
Milt Halliday,67,1,0,1,0.015,4,LW,1926,1929
Ivan Baranka,1,0,1,1,1.0,0,D,2007,2008
Carl Sneep,1,0,1,1,1.0,0,D,2011,2012
Chay Genoway,1,0,1,1,1.0,0,D,2011,2012
Bill Allum,1,0,1,1,1.0,0,D,1940,1941
Scott Harlow,1,0,1,1,1.0,0,LW,1987,1988
Turner Elson,1,0,1,1,1.0,0,C/LW,2015,2016
Jason Herter,1,0,1,1,1.0,0,D,1995,1996
Jeff Daw,1,0,1,1,1.0,0,C,2001,2002
Bill Armstrong,1,0,1,1,1.0,0,C,1990,1991
James Jamieson,1,0,1,1,1.0,0,D,1943,1944
Gord Byers,1,0,1,1,1.0,0,D,1949,1950
Paul Hurley,1,0,1,1,1.0,0,D,1968,1969
Murray Wing,1,0,1,1,1.0,0,D,1973,1974
Harry Bell,1,0,1,1,1.0,0,D,1946,1947
Alan Staley,1,0,1,1,1.0,0,C,1948,1949
Jimmy Schuldt,1,0,1,1,1.0,0,D,2018,2019
Jim McBurney,1,0,1,1,1.0,0,LW,1953,1954
Norm Collings,1,0,1,1,1.0,0,LW,1934,1935
Pierre-Olivier Joseph,1,0,1,1,1.0,0,D,2020,2021
Dan Ratushny,1,0,1,1,1.0,2,D,1992,1993
Thomas Rundqvist,2,0,1,1,0.5,0,C,1984,1985
David Gove,2,0,1,1,0.5,0,LW/C,2005,2007
Jakub Petruzalek,2,0,1,1,0.5,0,C/RW,2008,2009
Brian Salcido,2,0,1,1,0.5,0,D,2008,2009
Matt Anderson,2,0,1,1,0.5,0,RW/C,2012,2013
Joonas Rask,2,0,1,1,0.5,0,RW,2012,2013
Philippe Cornet,2,0,1,1,0.5,0,W/C,2011,2012
Kent Ruhnke,2,0,1,1,0.5,0,RW,1975,1976
Steve Peters,2,0,1,1,0.5,0,D/C,1979,1980
Doug Acomb,2,0,1,1,0.5,0,C/LW,1969,1970
Matt Lorito,2,0,1,1,0.5,0,RW/LW,2016,2017
Brian Sullivan,2,0,1,1,0.5,0,RW/LW,1992,1993
Ryan Bast,2,0,1,1,0.5,0,D,1998,1999
Craig Endean,2,0,1,1,0.5,0,LW,1986,1987
Jordan Gross,2,0,1,1,0.5,0,D,2019,2021
Cam Botting,2,0,1,1,0.5,0,RW,1975,1976
Ray Manson,2,0,1,1,0.5,0,LW,1947,1949
Gordie Haworth,2,0,1,1,0.5,0,C,1952,1953
Jeff Bandura,2,0,1,1,0.5,0,D,1980,1981
Miika Elomo,2,0,1,1,0.5,2,RW,1999,2000
Dwayne Lowdermilk,2,0,1,1,0.5,2,D,1980,1981
Bowen Byram,2,0,1,1,0.5,2,D,2020,2021
Michael Paliotta,2,0,1,1,0.5,4,D,2014,2016
Rosario Joanette,2,0,1,1,0.5,4,C,1944,1945
Kevin Devine,2,0,1,1,0.5,8,LW,1982,1983
Pierre Hedin,3,0,1,1,0.33299999999999996,0,D,2003,2004
Mikko Luoma,3,0,1,1,0.33299999999999996,0,D,2003,2004
Anton Rodin,3,0,1,1,0.33299999999999996,0,RW/LW,2016,2017
Tommy Cross,3,0,1,1,0.33299999999999996,0,D,2015,2017
Joel Savage,3,0,1,1,0.33299999999999996,0,RW,1990,1991
Bobby Jay,3,0,1,1,0.33299999999999996,0,D,1993,1994
John Polich,3,0,1,1,0.33299999999999996,0,RW,1939,1941
Archie Fraser,3,0,1,1,0.33299999999999996,0,C,1943,1944
Shane Gersich,3,0,1,1,0.33299999999999996,0,C/LW,2017,2018
Gage Quinney,3,0,1,1,0.33299999999999996,0,C/LW,2019,2021
Andre Corriveau,3,0,1,1,0.33299999999999996,0,RW,1953,1954
Nils Tremblay,3,0,1,1,0.33299999999999996,0,C,1944,1946
Brogan Rafferty,3,0,1,1,0.33299999999999996,0,D,2018,2021
Lulu Denis,3,0,1,1,0.33299999999999996,0,RW,1949,1951
John Negrin,3,0,1,1,0.33299999999999996,2,D,2008,2009
Dmitri Korobov,3,0,1,1,0.33299999999999996,2,D,2013,2014
Dale Rominski,3,0,1,1,0.33299999999999996,2,RW,1999,2000
Trevor Sim,3,0,1,1,0.33299999999999996,2,RW,1989,1990
Jim Brown,3,0,1,1,0.33299999999999996,5,D,1982,1983
Eric Selleck,3,0,1,1,0.33299999999999996,22,LW/RW,2012,2016
Owen Fussey,4,0,1,1,0.25,0,RW,2003,2004
Doug Adam,4,0,1,1,0.25,0,LW/RW,1949,1950
Michael Lauen,4,0,1,1,0.25,0,RW,1983,1984
Bob Cunningham,4,0,1,1,0.25,0,C,1960,1962
Guy Rousseau,4,0,1,1,0.25,0,LW,1954,1957
Jason Robertson,4,0,1,1,0.25,0,LW/RW,2019,2021
Mason Marchment,4,0,1,1,0.25,0,LW,2019,2021
Ben Gleason,4,0,1,1,0.25,0,D,2018,2019
Gary Dineen,4,0,1,1,0.25,0,C,1968,1969
K'Andre Miller,4,0,1,1,0.25,0,D,2020,2021
Al Buchanan,4,0,1,1,0.25,2,LW,1948,1950
Moe White,4,0,1,1,0.25,2,LW,1945,1946
Andrei Zubarev,4,0,1,1,0.25,4,D,2010,2011
Bill Burega,4,0,1,1,0.25,4,D,1955,1956
Jim Walsh,4,0,1,1,0.25,4,D,1981,1982
Connie Tudin,4,0,1,1,0.25,4,C,1941,1942
Marc Magnan,4,0,1,1,0.25,5,LW,1982,1983
Dan Clark,4,0,1,1,0.25,6,D,1978,1979
Ray Staszak,4,0,1,1,0.25,7,F,1985,1986
Eric Germain,4,0,1,1,0.25,13,D,1987,1988
Cade Fairchild,5,0,1,1,0.2,0,D,2011,2012
Martin Lojek,5,0,1,1,0.2,0,D,2006,2008
Duncan Milroy,5,0,1,1,0.2,0,RW,2006,2007
Blake Bellefeuille,5,0,1,1,0.2,0,C,2001,2003
Daniil Tarasov,5,0,1,1,0.2,0,RW/LW,2014,2015
Henrik Haapala,5,0,1,1,0.2,0,LW/RW,2017,2018
Moe L'Abbe,5,0,1,1,0.2,0,C,1972,1973
Pius Suter,5,0,1,1,0.2,0,C/LW,2020,2021
Ian Mitchell,5,0,1,1,0.2,0,D,2020,2021
Kristian Vesalainen,5,0,1,1,0.2,0,LW/RW,2018,2021
Nick Sorensen,5,0,1,1,0.2,2,RW,2016,2017
Todd Strueby,5,0,1,1,0.2,2,C,1981,1984
Red Carr,5,0,1,1,0.2,2,LW,1943,1944
Garth MacGuigan,5,0,1,1,0.2,2,C,1979,1984
Doug Shelton,5,0,1,1,0.2,2,RW,1967,1968
David Broll,5,0,1,1,0.2,5,LW,2013,2014
Mike Ware,5,0,1,1,0.2,15,D/RW,1988,1990
Brandon Nolan,6,0,1,1,0.16699999999999998,0,C,2007,2008
Alexei Kaigorodov,6,0,1,1,0.16699999999999998,0,C,2006,2007
Kevin Quick,6,0,1,1,0.16699999999999998,0,D,2008,2009
Chris Bala,6,0,1,1,0.16699999999999998,0,LW,2001,2002
Marty Dallman,6,0,1,1,0.16699999999999998,0,C,1987,1989
Victor Ejdsell,6,0,1,1,0.16699999999999998,0,C/W,2017,2018
Viv Allen,6,0,1,1,0.16699999999999998,0,RW,1940,1941
Cole Schneider,6,0,1,1,0.16699999999999998,0,LW/RW,2015,2017
Niko Mikkola,6,0,1,1,0.16699999999999998,0,D,2019,2021
Jeffrey Teal,6,0,1,1,0.16699999999999998,0,LW/C,1984,1985
Bob Guindon,6,0,1,1,0.16699999999999998,0,LW,1979,1980
Jonathan Davidsson,6,0,1,1,0.16699999999999998,0,RW,2019,2020
Keegan Kolesar,6,0,1,1,0.16699999999999998,0,RW,2019,2021
Lucas Carlsson,6,0,1,1,0.16699999999999998,0,D,2019,2021
Tim Gettinger,6,0,1,1,0.16699999999999998,0,LW,2018,2020
Cliff Simpson,6,0,1,1,0.16699999999999998,0,C,1946,1948
Chad Kolarik,6,0,1,1,0.16699999999999998,2,RW,2009,2011
Maxim Balmochnykh,6,0,1,1,0.16699999999999998,2,RW,1999,2000
Matt Henderson,6,0,1,1,0.16699999999999998,2,LW,1998,2002
Steve Bancroft,6,0,1,1,0.16699999999999998,2,D,1992,2002
Peter Sturgeon,6,0,1,1,0.16699999999999998,2,LW,1979,1981
Jim Culhane,6,0,1,1,0.16699999999999998,4,D,1989,1990
Todd Flichel,6,0,1,1,0.16699999999999998,4,D/RW,1987,1990
Barrie Meissner,6,0,1,1,0.16699999999999998,4,LW,1967,1969
Leo Carbol,6,0,1,1,0.16699999999999998,4,D,1942,1943
Pete Bessone,6,0,1,1,0.16699999999999998,6,D,1937,1938
Barry MacKenzie,6,0,1,1,0.16699999999999998,6,D,1968,1969
Martin Fehervary,6,0,1,1,0.16699999999999998,6,D,2019,2021
Michael Heidt,6,0,1,1,0.16699999999999998,7,D,1983,1984
Peter Helander,7,0,1,1,0.14300000000000002,0,D,1982,1983
Ryan Ready,7,0,1,1,0.14300000000000002,0,LW,2005,2006
Chris Armstrong,7,0,1,1,0.14300000000000002,0,D,2000,2004
Ryan Kraft,7,0,1,1,0.14300000000000002,0,C,2002,2003
Brian Ferlin,7,0,1,1,0.14300000000000002,0,RW,2014,2015
Tyler Benson,7,0,1,1,0.14300000000000002,0,LW,2019,2020
Jim Stanfield,7,0,1,1,0.14300000000000002,0,C,1969,1972
Brian Fahey,7,0,1,1,0.14300000000000002,2,D,2010,2011
Ray Macias,7,0,1,1,0.14300000000000002,2,D/RW,2008,2011
Steve Langdon,7,0,1,1,0.14300000000000002,2,RW,1974,1978
Jeff Brownschidle,7,0,1,1,0.14300000000000002,2,D,1981,1983
Ken Girard,7,0,1,1,0.14300000000000002,2,RW,1956,1960
Frank Bennett,7,0,1,1,0.14300000000000002,2,LW,1943,1944
Patrick Coulombe,7,0,1,1,0.14300000000000002,4,D,2006,2007
Cory LaRose,7,0,1,1,0.14300000000000002,4,C,2003,2004
Tyler Eckford,7,0,1,1,0.14300000000000002,4,D,2009,2011
Hazen McAndrew,7,0,1,1,0.14300000000000002,6,D,1941,1942
Jason Widmer,7,0,1,1,0.14300000000000002,7,D,1994,1997
Dwayne Zinger,7,0,1,1,0.14300000000000002,9,D,2003,2004
Radek Smolenak,7,0,1,1,0.14300000000000002,15,LW/RW,2008,2010
Gordie Clark,8,0,1,1,0.125,0,RW,1974,1976
Jack Markle,8,0,1,1,0.125,0,RW,1935,1936
Justin DiBenedetto,8,0,1,1,0.125,2,C/LW,2010,2011
Erik Burgdoerfer,8,0,1,1,0.125,2,D,2016,2019
Mark Friedman,8,0,1,1,0.125,2,D,2018,2021
Emile Poirier,8,0,1,1,0.125,2,C/W,2014,2016
Kevin Doell,8,0,1,1,0.125,4,C,2007,2008
Charles Luksa,8,0,1,1,0.125,4,D,1979,1980
Bobby Benson,8,0,1,1,0.125,4,D,1924,1925
Francois Groleau,8,0,1,1,0.125,6,D,1995,1998
Chris Corrinet,8,0,1,1,0.125,6,F,2001,2002
Terry McDonald,8,0,1,1,0.125,6,D,1975,1976
Dan Brennan,8,0,1,1,0.125,9,F,1983,1986
Leigh Verstraete,8,0,1,1,0.125,14,RW,1982,1988
Ray Podloski,8,0,1,1,0.125,17,C,1988,1989
Denis Larocque,8,0,1,1,0.125,18,D,1987,1988
Mike Liambas,8,0,1,1,0.125,21,LW,2016,2018
Corey Locke,9,0,1,1,0.111,0,C,2007,2011
Jean-Louis Bourcier,9,0,1,1,0.111,0,LW,1935,1936
Dan McFall,9,0,1,1,0.111,0,D,1984,1986
Jaret Anderson-Dolan,9,0,1,1,0.111,0,C/LW,2018,2021
Tony Licari,9,0,1,1,0.111,0,RW,1946,1947
Roman Tvrdon,9,0,1,1,0.111,2,RW,2003,2004
Don Cairns,9,0,1,1,0.111,2,LW,1975,1977
Kirby Law,9,0,1,1,0.111,4,RW,2000,2004
Maxime Fortunus,9,0,1,1,0.111,4,D,2009,2014
David Brine,9,0,1,1,0.111,4,C,2007,2008
Ed Cristofoli,9,0,1,1,0.111,4,RW,1989,1990
Jeannot Gilbert,9,0,1,1,0.111,4,C,1962,1965
JC Lipon,9,0,1,1,0.111,5,RW,2015,2016
Jason Jaspers,9,0,1,1,0.111,6,C,2001,2004
Mat Clark,9,0,1,1,0.111,6,D,2011,2015
Alain Belanger,9,0,1,1,0.111,6,RW,1977,1978
Christoph Bertschy,9,0,1,1,0.111,8,C/W,2015,2018
Gilles Bilodeau,9,0,1,1,0.111,25,D,1979,1980
Mike Moher,9,0,1,1,0.111,28,RW,1982,1983
Ron Talakoski,9,0,1,1,0.111,33,RW,1986,1988
Kevin Evans,9,0,1,1,0.111,44,LW,1990,1992
Bruce Greig,9,0,1,1,0.111,46,LW,1973,1975
Brian Kinsella,10,0,1,1,0.1,0,RW,1975,1977
Ryan MacInnis,10,0,1,1,0.1,0,C/LW,2019,2021
Clarence Drouillard,10,0,1,1,0.1,0,C,1937,1938
Sergei Zinovyev,10,0,1,1,0.1,2,C,2003,2004
Cameron Schilling,10,0,1,1,0.1,4,D,2012,2019
Alexander Volkov,10,0,1,1,0.1,6,RW/LW,2019,2021
Bernie Saunders,10,0,1,1,0.1,8,RW,1979,1981
Tommy Smith,10,0,1,1,0.1,11,C,1919,1920
Bryan Adams,11,0,1,1,0.091,2,LW/C,1999,2001
Dave Downie,11,0,1,1,0.091,2,C,1932,1933
Bob Liddington,11,0,1,1,0.091,2,LW,1970,1971
Timothy Liljegren,11,0,1,1,0.091,2,D,2019,2020
Mark Katic,11,0,1,1,0.091,4,D,2010,2011
Viktors Ignatjevs,11,0,1,1,0.091,6,D,1998,1999
Johan Sundstrom,11,0,1,1,0.091,6,C/RW,2013,2014
Mathieu Olivier,11,0,1,1,0.091,6,RW,2019,2021
Timo Helbling,11,0,1,1,0.091,8,D,2005,2007
Kyle Rossiter,11,0,1,1,0.091,9,D,2001,2004
Triston Grant,11,0,1,1,0.091,19,LW,2006,2010
Al Simmons,11,0,1,1,0.091,21,D,1971,1976
Peter Ambroziak,12,0,1,1,0.083,0,LW,1994,1995
Matt Ryan,12,0,1,1,0.083,2,C/LW,2005,2006
Michel Riesen,12,0,1,1,0.083,4,RW,2000,2001
Lean Bergmann,12,0,1,1,0.083,4,C/W,2019,2020
Brendan Shinnimin,12,0,1,1,0.083,8,C/LW,2014,2015
Harry Dick,12,0,1,1,0.083,12,D,1946,1947
Ryan Lomberg,12,0,1,1,0.083,32,LW,2017,2021
Sean Gagnon,12,0,1,1,0.083,34,D,1997,2001
Travis Morin,13,0,1,1,0.077,0,C,2010,2015
Norm McAtee,13,0,1,1,0.077,0,F,1946,1947
Cliff Thompson,13,0,1,1,0.077,2,D,1941,1949
Arnie Kullman,13,0,1,1,0.077,11,C,1947,1950
Martin Samuelsson,14,0,1,1,0.071,2,RW,2002,2004
Lars Zetterstrom,14,0,1,1,0.071,2,D,1978,1979
Greg Jacina,14,0,1,1,0.071,6,C/RW,2005,2007
Claude Julien,14,0,1,1,0.071,25,D,1984,1986
Greg Nemisz,15,0,1,1,0.067,0,RW,2010,2012
Todd Simon,15,0,1,1,0.067,0,C,1993,1994
Eddie Jeremiah,15,0,1,1,0.067,0,RW,1931,1932
Frank Dunlap,15,0,1,1,0.067,2,RW,1943,1944
Jarrett Deuling,15,0,1,1,0.067,11,LW,1995,1997
Michael Colman,15,0,1,1,0.067,32,D,1991,1992
Sergei Starikov,16,0,1,1,0.063,8,D,1989,1990
Darrell Scoville,16,0,1,1,0.063,12,D,1999,2004
Gustav Lindstrom,16,0,1,1,0.063,14,D,2019,2021
Dave Marcinyshyn,16,0,1,1,0.063,49,D,1990,1993
Gerry Denoird,17,0,1,1,0.059000000000000004,0,C,1922,1923
Claudio Scremin,17,0,1,1,0.059000000000000004,29,D,1991,1993
Gord Redahl,18,0,1,1,0.055999999999999994,2,F,1958,1959
Luke Johnson,18,0,1,1,0.055999999999999994,8,C,2018,2020
Dave Watson,18,0,1,1,0.055999999999999994,10,F,1979,1981
Casey Hankinson,18,0,1,1,0.055999999999999994,13,LW,2000,2004
Harry Radley,18,0,1,1,0.055999999999999994,13,D,1930,1937
Doug Friedman,18,0,1,1,0.055999999999999994,34,LW,1997,1999
T.J. Tynan,19,0,1,1,0.053,2,C/W,2016,2020
Alex Brooks,19,0,1,1,0.053,4,D,2006,2007
Al Nicholson,19,0,1,1,0.053,4,LW,1955,1957
Frank Heffernan,19,0,1,1,0.053,10,D,1919,1920
Bob Lemieux,19,0,1,1,0.053,12,D,1967,1968
Ivan Droppa,19,0,1,1,0.053,14,D,1993,1996
Burr Williams,19,0,1,1,0.053,28,D,1933,1937
Shawn Belle,20,0,1,1,0.05,2,D,2006,2011
Brett Lernout,21,0,1,1,0.048,6,D,2015,2018
Jeff Ware,21,0,1,1,0.048,12,D,1996,1999
Darren Reid,21,0,1,1,0.048,18,RW,2005,2007
Craig Martin,21,0,1,1,0.048,24,RW,1994,1997
Joe Finley,21,0,1,1,0.048,32,D,2011,2013
J.C. Beaudin,22,0,1,1,0.045,7,C/RW,2019,2020
Nikolai Tsulygin,22,0,1,1,0.045,8,D,1996,1997
Rob Robinson,22,0,1,1,0.045,8,D,1991,1992
Mike Vernace,22,0,1,1,0.045,10,D,2008,2011
Davis Payne,22,0,1,1,0.045,14,RW,1995,1997
Gordon Kannegiesser,23,0,1,1,0.043,15,D,1967,1972
Kyle Freadrich,23,0,1,1,0.043,75,LW,1999,2001
Doug Baldwin,24,0,1,1,0.042,8,D,1945,1948
Tom Fowler,24,0,1,1,0.042,18,C,1946,1947
Colten Teubert,24,0,1,1,0.042,25,D,2011,2012
Sammy McManus,26,0,1,1,0.038,8,LW,1934,1937
Gregory Stewart,26,0,1,1,0.038,48,LW,2007,2010
Joel Rechlicz,26,0,1,1,0.038,105,RW,2008,2012
Val Hoffinger,28,0,1,1,0.036,30,D,1927,1929
Warren Luhning,29,0,1,1,0.034,21,RW,1997,2000
Bennett Wolf,30,0,1,1,0.033,133,D,1980,1983
Charles Cahill,32,0,1,1,0.031,4,RW,1925,1927
James Donnelly,34,0,1,1,0.029,14,D,1926,1927
Don Ward,34,0,1,1,0.029,16,D,1957,1960
Nathan McIver,36,0,1,1,0.028,95,D,2006,2009
Doug Doull,37,0,1,1,0.027,151,LW,2003,2006
James Hughes,40,0,1,1,0.025,48,D,1929,1930
Murray Anderson,40,0,1,1,0.025,68,D,1974,1975
Robin Bartel,41,0,1,1,0.024,14,D,1985,1987
Bob Davie,41,0,1,1,0.024,25,D,1933,1936
Johnathan Aitken,44,0,1,1,0.023,70,D,1999,2004
Larry Molyneaux,45,0,1,1,0.022,20,D,1937,1939
Jim Agnew,81,0,1,1,0.012,257,D,1986,1993
Brennan Evans,0,0,0,0,0.0,0,D,2003,2004
Brock Tredway,0,0,0,0,0.0,0,LW,1981,1982
Bill Anderson,0,0,0,0,0.0,0,D,1942,1943
Don Cherry,0,0,0,0,0.0,0,D,1954,1955
Alex Belzile,0,0,0,0,0.0,0,RW/C,2019,2020
Igor Nikulin,0,0,0,0,0.0,0,RW,1996,1997
Michel Deziel,0,0,0,0,0.0,0,LW,1974,1975
Steve Andrascik,0,0,0,0,0.0,0,RW,1971,1972
Chris Hayes,0,0,0,0,0.0,0,LW,1971,1972
Doug Anderson,0,0,0,0,0.0,0,C,1952,1953
Ken Davies,0,0,0,0,0.0,0,C,1947,1948
Wayne Brown,0,0,0,0,0.0,0,RW,1953,1954
Gord Wilson,0,0,0,0,0.0,0,LW,1954,1955
Jack Stanfield,0,0,0,0,0.0,0,LW,1965,1966
Gary Collins,0,0,0,0,0.0,0,C,1958,1959
David Salvian,0,0,0,0,0.0,0,RW,1976,1977
Leo Thiffault,0,0,0,0,0.0,0,LW,1967,1968
Eddie Emberg,0,0,0,0,0.0,0,C,1944,1945
Gord Haidy,0,0,0,0,0.0,0,RW,1949,1950
Mike Corbett,0,0,0,0,0.0,0,RW,1967,1968
Doug McKay,0,0,0,0,0.0,0,LW,1949,1950
Sidney McNabney,0,0,0,0,0.0,0,C,1950,1951
Stan Long,0,0,0,0,0.0,0,D,1951,1952
Butch Stahan,0,0,0,0,0.0,0,D,1944,1945
Gerry Reid,0,0,0,0,0.0,0,C,1948,1949
Thomas Harley,0,0,0,0,0.0,0,D,2019,2021
Ronnie Sundin,1,0,0,0,0.0,0,D,1997,1998
Mikko Jokela,1,0,0,0,0.0,0,D,2002,2003
Martti Jarventie,1,0,0,0,0.0,0,D,2001,2002
Masi Marjamaki,1,0,0,0,0.0,0,LW,2005,2006
Tomi Maki,1,0,0,0,0.0,0,C/W,2006,2007
Petri Varis,1,0,0,0,0.0,0,RW,1997,1998
Bjorn Skaare,1,0,0,0,0.0,0,C,1978,1979
Perttu Lindgren,1,0,0,0,0.0,0,C,2009,2010
Johan Motin,1,0,0,0,0.0,0,D,2009,2010
Andre Petersson,1,0,0,0,0.0,0,LW/RW,2011,2012
David Moravec,1,0,0,0,0.0,0,LW,1999,2000
Chris Kelleher,1,0,0,0,0.0,0,D,2001,2002
Darren Boyko,1,0,0,0,0.0,0,C,1988,1989
Jamie Hunt,1,0,0,0,0.0,0,D,2006,2007
Nate Raduns,1,0,0,0,0.0,0,RW,2008,2009
Tim Ramholt,1,0,0,0,0.0,0,D,2007,2008
Layne Ulmer,1,0,0,0,0.0,0,C,2003,2004
Libor Pivko,1,0,0,0,0.0,0,LW,2003,2004
Curtis Murphy,1,0,0,0,0.0,0,D,2002,2003
Vaclav Pletka,1,0,0,0,0.0,0,LW,2001,2002
Stanislav Gron,1,0,0,0,0.0,0,C,2000,2001
Philip Holm,1,0,0,0,0.0,0,D,2017,2018
Shawn Lalonde,1,0,0,0,0.0,0,D,2012,2013
Jamie Arniel,1,0,0,0,0.0,0,C,2010,2011
Ryan Thang,1,0,0,0,0.0,0,RW/LW,2011,2012
Brodie Dupont,1,0,0,0,0.0,0,LW/C,2010,2011
Jamie Fraser,1,0,0,0,0.0,0,D,2008,2009
Joey Tenute,1,0,0,0,0.0,0,C,2005,2006
Scott Jackson,1,0,0,0,0.0,0,D,2009,2010
Bud Holloway,1,0,0,0,0.0,0,RW,2015,2016
Scott Lehman,1,0,0,0,0.0,0,D,2008,2009
Milan Kytnar,1,0,0,0,0.0,0,C,2011,2012
Zack Fitzgerald,1,0,0,0,0.0,0,D,2007,2008
Darcy Campbell,1,0,0,0,0.0,0,D,2006,2007
Nick Petrecki,1,0,0,0,0.0,0,D,2012,2013
Will O'Neill,1,0,0,0,0.0,0,D,2017,2018
Peter LeBlanc,1,0,0,0,0.0,0,LW/C,2013,2014
Shane Sims,1,0,0,0,0.0,0,D,2010,2011
Brad Ralph,1,0,0,0,0.0,0,C,2000,2001
Cole Jarrett,1,0,0,0,0.0,0,D,2005,2006
Joey Mormina,1,0,0,0,0.0,0,D,2007,2008
Andrew Joudrey,1,0,0,0,0.0,0,C,2011,2012
Grant Lewis,1,0,0,0,0.0,0,D,2008,2009
Matt Watkins,1,0,0,0,0.0,0,C/LW,2011,2012
Mark Van Guilder,1,0,0,0,0.0,0,C,2013,2014
Greg Kuznik,1,0,0,0,0.0,0,D,2000,2001
Joonas Nattinen,1,0,0,0,0.0,0,C/RW,2013,2014
Michael Keranen,1,0,0,0,0.0,0,W/C,2015,2016
Ryan Bourque,1,0,0,0,0.0,0,C/LW,2014,2015
Maxime Sauve,1,0,0,0,0.0,0,C,2011,2012
Anton Klementyev,1,0,0,0,0.0,0,D,2009,2010
Roman Graborenko,1,0,0,0,0.0,0,D,2014,2015
Garrett Mitchell,1,0,0,0,0.0,0,RW/C,2016,2017
Mike Murray,1,0,0,0,0.0,0,C,1987,1988
Sean McMorrow,1,0,0,0,0.0,0,RW,2002,2003
Brendan Ranford,1,0,0,0,0.0,0,LW/RW,2014,2015
Eric Lavigne,1,0,0,0,0.0,0,D,1994,1995
Bud Stefanski,1,0,0,0,0.0,0,F,1977,1978
Wayne Groulx,1,0,0,0,0.0,0,C,1984,1985
Jozef Cierny,1,0,0,0,0.0,0,LW,1993,1994
Colin Smith,1,0,0,0,0.0,0,C/RW,2014,2015
Fredrik Handemark,1,0,0,0,0.0,0,C,2020,2021
Shawn Heaphy,1,0,0,0,0.0,0,C,1992,1993
Jamie Doornbosch,1,0,0,0,0.0,0,D,2010,2011
Darryl Olsen,1,0,0,0,0.0,0,D,1991,1992
Scott McKay,1,0,0,0,0.0,0,RW,1993,1994
Yves Heroux,1,0,0,0,0.0,0,RW,1986,1987
Francois Guay,1,0,0,0,0.0,0,C,1989,1990
David Van Drunen,1,0,0,0,0.0,0,D,1999,2000
Alex Friesen,1,0,0,0,0.0,0,C,2015,2016
Gerry Abel,1,0,0,0,0.0,0,LW,1966,1967
Kris Foucault,1,0,0,0,0.0,0,LW,2011,2012
Rudy Ahlin,1,0,0,0,0.0,0,LW,1937,1938
Jesse Blacker,1,0,0,0,0.0,0,D,2014,2015
David Sloane,1,0,0,0,0.0,0,D/RW,2008,2009
Geoff Kinrade,1,0,0,0,0.0,0,D,2008,2009
Jamie Fritsch,1,0,0,0,0.0,0,D,2008,2009
Greg Koehler,1,0,0,0,0.0,0,C,2000,2001
Shane MacEachern,1,0,0,0,0.0,0,C,1987,1988
Bill Arnold,1,0,0,0,0.0,0,C/RW,2013,2014
Alexander Andriyevsky,1,0,0,0,0.0,0,RW,1992,1993
Darrel Anholt,1,0,0,0,0.0,0,D,1983,1984
Don Waddell,1,0,0,0,0.0,0,D,1980,1981
Jonathan Delisle,1,0,0,0,0.0,0,RW,1998,1999
Cody Kunyk,1,0,0,0,0.0,0,C,2013,2014
Curtis Valk,1,0,0,0,0.0,0,C,2017,2018
Lindsay Vallis,1,0,0,0,0.0,0,RW,1993,1994
Cameron Hughes,1,0,0,0,0.0,0,C/LW,2019,2020
Morgan Klimchuk,1,0,0,0,0.0,0,LW,2017,2018
Jeff Libby,1,0,0,0,0.0,0,D,1997,1998
Stephen Tepper,1,0,0,0,0.0,0,RW,1992,1993
B.J. Young,1,0,0,0,0.0,0,RW,1999,2000
Erich Goldmann,1,0,0,0,0.0,0,D,1999,2000
Greg Crozier,1,0,0,0,0.0,0,LW,2000,2001
Ryan Huska,1,0,0,0,0.0,0,LW,1997,1998
Rod Willard,1,0,0,0,0.0,0,LW,1982,1983
Justin Hocking,1,0,0,0,0.0,0,D,1993,1994
Nick Vachon,1,0,0,0,0.0,0,C,1996,1997
Peter Fiorentino,1,0,0,0,0.0,0,D,1991,1992
Evan McEneny,1,0,0,0,0.0,0,D,2016,2017
Dan Renouf,1,0,0,0,0.0,0,D,2016,2017
Sean Toomey,1,0,0,0,0.0,0,C,1986,1987
Ken Lovsin,1,0,0,0,0.0,0,D,1990,1991
Tyler Larter,1,0,0,0,0.0,0,C,1989,1990
Trent Kaese,1,0,0,0,0.0,0,F,1988,1989
Kirk Tomlinson,1,0,0,0,0.0,0,LW,1987,1988
Ken Mann,1,0,0,0,0.0,0,RW,1975,1976
Rob Laird,1,0,0,0,0.0,0,LW,1979,1980
Stephane Brochu,1,0,0,0,0.0,0,D,1988,1989
Anthony Greco,1,0,0,0,0.0,0,RW/LW,2018,2019
Bobby Joliat,1,0,0,0,0.0,0,RW,1924,1925
Dean Clark,1,0,0,0,0.0,0,LW,1983,1984
Bill Johansen,1,0,0,0,0.0,0,C,1949,1950
James Latos,1,0,0,0,0.0,0,RW,1988,1989
Brett MacDonald,1,0,0,0,0.0,0,D,1987,1988
Darin Sceviour,1,0,0,0,0.0,0,F,1986,1987
Peter Hayek,1,0,0,0,0.0,0,D/LW,1981,1982
Colin Chisholm,1,0,0,0,0.0,0,D,1986,1987
Vic Teal,1,0,0,0,0.0,0,RW,1973,1974
Ron Homenuke,1,0,0,0,0.0,0,F,1972,1973
Bogdan Yakimov,1,0,0,0,0.0,0,C,2014,2015
Sean Malone,1,0,0,0,0.0,0,C,2016,2017
Gary Donaldson,1,0,0,0,0.0,0,F,1973,1974
Gene Sobchuk,1,0,0,0,0.0,0,LW,1973,1974
Brian Pinho,1,0,0,0,0.0,0,C,2019,2021
Kim MacDougall,1,0,0,0,0.0,0,D,1974,1975
George McNaughton,1,0,0,0,0.0,0,RW,1919,1920
Alex Wellington,1,0,0,0,0.0,0,RW,1919,1920
Giovanni Fiore,1,0,0,0,0.0,0,LW/RW,2017,2018
Max Bennett,1,0,0,0,0.0,0,RW,1935,1936
Garry Blaine,1,0,0,0,0.0,0,RW,1954,1955
Spence Tatchell,1,0,0,0,0.0,0,F,1942,1943
Bob McDonald,1,0,0,0,0.0,0,RW,1943,1944
Lloyd Mohns,1,0,0,0,0.0,0,D,1943,1944
Henry Dyck,1,0,0,0,0.0,0,LW,1943,1944
Len Wharton,1,0,0,0,0.0,0,D,1944,1945
Alex Ritson,1,0,0,0,0.0,0,C,1944,1945
Melvin Read,1,0,0,0,0.0,0,C,1946,1947
Larry Kwong,1,0,0,0,0.0,0,C,1947,1948
Val Delory,1,0,0,0,0.0,0,LW,1948,1949
Dick Kotanen,1,0,0,0,0.0,0,D,1950,1951
Bill Wylie,1,0,0,0,0.0,0,C,1950,1951
Robert Wood,1,0,0,0,0.0,0,D,1950,1951
William Chalmers,1,0,0,0,0.0,0,C,1953,1954
Dick Bouchard,1,0,0,0,0.0,0,RW,1954,1955
Trevor Fahey,1,0,0,0,0.0,0,LW,1964,1965
Mike Keating,1,0,0,0,0.0,0,LW,1977,1978
Greg Hickey,1,0,0,0,0.0,0,LW,1977,1978
Moe Robinson,1,0,0,0,0.0,0,D,1979,1980
Marcel Fillion,1,0,0,0,0.0,0,RW,1944,1945
Armand Delmonte,1,0,0,0,0.0,0,RW,1945,1946
Ken Block,1,0,0,0,0.0,0,D,1970,1971
Bart Bradley,1,0,0,0,0.0,0,C,1949,1950
Skip Teal,1,0,0,0,0.0,0,C,1954,1955
Dan Poliziani,1,0,0,0,0.0,0,RW,1958,1959
Murray Davison,1,0,0,0,0.0,0,D,1965,1966
Jake Rathwell,1,0,0,0,0.0,0,LW,1974,1975
Vern Smith,1,0,0,0,0.0,0,D,1984,1985
Chuck Blair,1,0,0,0,0.0,0,RW,1948,1949
Hillary Menard,1,0,0,0,0.0,0,LW,1953,1954
John Michaluk,1,0,0,0,0.0,0,LW,1950,1951
Raymie Skilton,1,0,0,0,0.0,0,D,1917,1918
Kenneth Thompson,1,0,0,0,0.0,0,LW,1917,1918
Paul Jacobs,1,0,0,0,0.0,0,D,1918,1919
Jeff Eatough,1,0,0,0,0.0,0,RW,1981,1982
Mitch Reinke,1,0,0,0,0.0,0,D,2017,2018
Mike Chernoff,1,0,0,0,0.0,0,LW,1968,1969
C.J. Suess,1,0,0,0,0.0,0,LW,2019,2021
Paul Knox,1,0,0,0,0.0,0,RW,1954,1955
Jack Martin,1,0,0,0,0.0,0,RW,1960,1961
Bruce Draper,1,0,0,0,0.0,0,F,1962,1963
Charles Pletsch,1,0,0,0,0.0,0,F,1920,1921
Charles Fraser,1,0,0,0,0.0,0,D,1923,1924
Brandon Gignac,1,0,0,0,0.0,0,C/LW,2018,2019
Nicolas Meloche,1,0,0,0,0.0,0,D,2020,2021
Sidney Veysey,1,0,0,0,0.0,0,C,1977,1978
Brady Keeper,1,0,0,0,0.0,0,D,2018,2021
Barney Stanley,1,0,0,0,0.0,0,RW,1927,1928
Austin Poganski,1,0,0,0,0.0,0,RW,2019,2021
Galen Head,1,0,0,0,0.0,0,RW,1967,1968
Farrand Gillie,1,0,0,0,0.0,0,LW,1928,1929
Claude Cardin,1,0,0,0,0.0,0,LW,1967,1968
Roland Lafleur,1,0,0,0,0.0,0,LW,1924,1925
Roger Pelletier,1,0,0,0,0.0,0,D,1967,1968
Evariste Payer,1,0,0,0,0.0,0,C,1917,1918
Glenn Tomalty,1,0,0,0,0.0,0,C,1979,1980
Cole Smith,1,0,0,0,0.0,0,LW,2020,2021
Cal Foote,1,0,0,0,0.0,0,D,2020,2021
Jake Walman,1,0,0,0,0.0,0,D,2019,2021
Tony Poeta,1,0,0,0,0.0,0,RW,1951,1952
Bob Whitlock,1,0,0,0,0.0,0,C,1969,1970
Dave Chartier,1,0,0,0,0.0,0,C,1980,1981
Stephen Hazlett,1,0,0,0,0.0,0,C,1979,1980
Keith Wright,1,0,0,0,0.0,0,LW,1967,1968
Rob Garner,1,0,0,0,0.0,0,C,1982,1983
Alex Forsyth,1,0,0,0,0.0,0,C,1976,1977
Jeff McDill,1,0,0,0,0.0,0,RW,1976,1977
Ed Nicholson,1,0,0,0,0.0,0,D,1947,1948
Nels Podolsky,1,0,0,0,0.0,0,LW,1948,1949
Mike Buchanan,1,0,0,0,0.0,0,D,1951,1952
John McCahill,1,0,0,0,0.0,0,D,1977,1978
Fred Doherty,1,0,0,0,0.0,0,F,1918,1919
Charles Fortier,1,0,0,0,0.0,0,F,1923,1924
Dave Rochefort,1,0,0,0,0.0,0,C,1966,1967
Walt Farrant,1,0,0,0,0.0,0,RW,1943,1944
Blair Barnes,1,0,0,0,0.0,0,RW,1982,1983
Jack Borotsik,1,0,0,0,0.0,0,LW,1974,1975
Roger Cormier,1,0,0,0,0.0,0,RW,1925,1926
Hugh Currie,1,0,0,0,0.0,0,D,1950,1951
Frank Steele,1,0,0,0,0.0,0,RW,1930,1931
Ken Duggan,1,0,0,0,0.0,0,D,1987,1988
Neil Hawryliw,1,0,0,0,0.0,0,RW,1981,1982
John Ingram,1,0,0,0,0.0,0,C,1924,1925
Earl Johnson,1,0,0,0,0.0,0,LW,1953,1954
Bob Wilson,1,0,0,0,0.0,0,D,1953,1954
Ernie Laforce,1,0,0,0,0.0,0,D,1942,1943
Bobby Lee,1,0,0,0,0.0,0,C,1942,1943
Dave Lucas,1,0,0,0,0.0,0,D,1962,1963
Frank Mailley,1,0,0,0,0.0,0,D,1942,1943
Bob McCulley,1,0,0,0,0.0,0,D,1934,1935
Bill Mitchell,1,0,0,0,0.0,0,D,1963,1964
Brian Murphy,1,0,0,0,0.0,0,C,1974,1975
Bert Peer,1,0,0,0,0.0,0,RW,1939,1940
Barry Sullivan,1,0,0,0,0.0,0,RW,1947,1948
Brian Stapleton,1,0,0,0,0.0,0,RW,1975,1976
Nicolas Beaudin,1,0,0,0,0.0,0,D,2019,2021
Victor Soderstrom,1,0,0,0,0.0,0,D,2020,2021
Nicholas Robertson,1,0,0,0,0.0,0,C/LW,2019,2021
Jonas Johansson,1,0,0,0,0.0,2,RW,2005,2006
Luke Sellars,1,0,0,0,0.0,2,D,2001,2002
Wade Skolney,1,0,0,0,0.0,2,D,2005,2006
Sean Bentivoglio,1,0,0,0,0.0,2,LW,2008,2009
Prestin Ryan,1,0,0,0,0.0,2,D,2005,2006
Julien Vauclair,1,0,0,0,0.0,2,D,2003,2004
Scott Glennie,1,0,0,0,0.0,2,RW/C,2011,2012
Tyler Cuma,1,0,0,0,0.0,2,D,2011,2012
Alexei S. Vasilyev,1,0,0,0,0.0,2,D,1999,2000
Dalton Smith,1,0,0,0,0.0,2,LW,2019,2020
Matt Campanale,1,0,0,0,0.0,2,D,2010,2011
Sergei Klimovich,1,0,0,0,0.0,2,C,1996,1997
Udo Kiessling,1,0,0,0,0.0,2,D,1982,1983
Jonathan Racine,1,0,0,0,0.0,2,D,2013,2014
Scott Robinson,1,0,0,0,0.0,2,RW,1989,1990
Darwin McCutcheon,1,0,0,0,0.0,2,D,1981,1982
Brandy Semchuk,1,0,0,0,0.0,2,RW,1992,1993
Kevin MacDonald,1,0,0,0,0.0,2,D,1993,1994
Martin St-Amour,1,0,0,0,0.0,2,LW,1992,1993
Tom Colley,1,0,0,0,0.0,2,C,1974,1975
Lester Patrick,1,0,0,0,0.0,2,D,1926,1928
Rich Healey,1,0,0,0,0.0,2,D,1960,1961
Randy Turnbull,1,0,0,0,0.0,2,D,1981,1982
Stan Kemp,1,0,0,0,0.0,2,D,1948,1949
Andy Barbe,1,0,0,0,0.0,2,RW,1950,1951
Bob Sabourin,1,0,0,0,0.0,2,LW,1951,1952
Josh Teves,1,0,0,0,0.0,2,D,2018,2019
Rem Pitlick,1,0,0,0,0.0,2,C,2018,2019
Blair MacKasey,1,0,0,0,0.0,2,D,1976,1977
Gordon Reid,1,0,0,0,0.0,2,D,1936,1937
Marty Zoborosky,1,0,0,0,0.0,2,D,1944,1945
Bob Geale,1,0,0,0,0.0,2,C,1984,1985
Brian Lundberg,1,0,0,0,0.0,2,D,1982,1983
Bob Hurlbut,1,0,0,0,0.0,2,LW,1974,1975
Irv McGibbon,1,0,0,0,0.0,2,RW,1942,1943
Ty Dellandrea,1,0,0,0,0.0,2,C,2020,2021
Jonathan Sigalet,1,0,0,0,0.0,4,D,2006,2007
Pat Mayer,1,0,0,0,0.0,4,D,1987,1988
James Cunningham,1,0,0,0,0.0,4,LW,1977,1978
Jeremy Yablonski,1,0,0,0,0.0,5,RW,2003,2004
Sean Selmser,1,0,0,0,0.0,5,LW,2000,2001
Curtis Hamilton,1,0,0,0,0.0,5,LW/RW,2014,2015
Brian Wesenberg,1,0,0,0,0.0,5,RW,1998,1999
Danny Bois,1,0,0,0,0.0,7,RW/C,2006,2007
Cam Brown,1,0,0,0,0.0,7,LW,1990,1991
Peter Nordstrom,2,0,0,0,0.0,0,LW,1998,1999
Niklas Sundblad,2,0,0,0,0.0,0,RW,1995,1996
Peter Gustavsson,2,0,0,0,0.0,0,RW,1981,1982
Tomas Srsen,2,0,0,0,0.0,0,RW,1990,1991
Olli Malmivaara,2,0,0,0,0.0,0,D,2007,2008
Shay Stephenson,2,0,0,0,0.0,0,LW,2006,2007
Brian White,2,0,0,0,0.0,0,D,1998,1999
Alexei Mikhnov,2,0,0,0,0.0,0,LW/RW,2006,2007
Jamie Tardif,2,0,0,0,0.0,0,RW,2012,2013
Adam Berti,2,0,0,0,0.0,0,LW/D,2007,2008
Mike Siklenka,2,0,0,0,0.0,0,D,2002,2004
Ian MacNeil,2,0,0,0,0.0,0,C,2002,2003
Jesse Schultz,2,0,0,0,0.0,0,RW,2006,2007
Michael Caruso,2,0,0,0,0.0,0,D,2012,2013
Sebastien Bisaillon,2,0,0,0,0.0,0,D,2006,2007
Brock Trotter,2,0,0,0,0.0,0,W/C,2009,2010
Rob Shearer,2,0,0,0,0.0,0,C,2000,2001
Doug Lynch,2,0,0,0,0.0,0,D,2003,2004
Danny Irmen,2,0,0,0,0.0,0,C/RW,2009,2010
Peter Vandermeer,2,0,0,0,0.0,0,LW,2007,2008
Greg Leeb,2,0,0,0,0.0,0,C,2000,2001
Derek Whitmore,2,0,0,0,0.0,0,LW,2011,2012
Steve Brule,2,0,0,0,0.0,0,RW,1999,2003
Drew LeBlanc,2,0,0,0,0.0,0,C,2012,2013
Carter Bancks,2,0,0,0,0.0,0,LW/RW,2012,2013
Jeff Penner,2,0,0,0,0.0,0,D,2009,2010
Darcy Martini,2,0,0,0,0.0,0,D,1993,1994
Spencer Abbott,2,0,0,0,0.0,0,RW,2013,2017
Mark McNeill,2,0,0,0,0.0,0,C/RW,2015,2017
Cam Plante,2,0,0,0,0.0,0,D,1984,1985
John Ramage,2,0,0,0,0.0,0,D,2014,2016
Brendon Nash,2,0,0,0,0.0,0,D,2010,2011
Matthew Konan,2,0,0,0,0.0,0,D,2012,2013
Jacob Nilsson,2,0,0,0,0.0,0,C/LW,2018,2019
Tony Cimellaro,2,0,0,0,0.0,0,C,1992,1993
Ben Sexton,2,0,0,0,0.0,0,C/RW,2017,2018
Larry Huras,2,0,0,0,0.0,0,D,1976,1977
Bill Whelton,2,0,0,0,0.0,0,D,1980,1981
Jamie Devane,2,0,0,0,0.0,0,LW,2013,2014
Brandon DeFazio,2,0,0,0,0.0,0,LW/RW,2014,2015
Dominik Uher,2,0,0,0,0.0,0,C,2014,2015
Ron Carter,2,0,0,0,0.0,0,RW,1979,1980
Jon Fontas,2,0,0,0,0.0,0,C,1979,1981
Doug Trapp,2,0,0,0,0.0,0,F,1986,1987
Brad Church,2,0,0,0,0.0,0,LW,1997,1998
Kai Suikkanen,2,0,0,0,0.0,0,F,1981,1983
Scott Scissons,2,0,0,0,0.0,0,C,1990,1994
Rick Mrozik,2,0,0,0,0.0,0,C,2002,2003
Ryan Barnes,2,0,0,0,0.0,0,LW,2003,2004
Dave Duerden,2,0,0,0,0.0,0,LW,1999,2000
Stephane Charbonneau,2,0,0,0,0.0,0,RW,1991,1992
Brad Zavisha,2,0,0,0,0.0,0,LW,1993,1994
Daniel Guerard,2,0,0,0,0.0,0,RW,1994,1995
Shaun Sabol,2,0,0,0,0.0,0,D,1989,1990
Mikhail Kravets,2,0,0,0,0.0,0,RW,1991,1993
Eric Calder,2,0,0,0,0.0,0,D,1981,1983
Jim Drummond,2,0,0,0,0.0,0,D,1944,1945
Yvan Joly,2,0,0,0,0.0,0,RW,1979,1983
Harry Pidhirny,2,0,0,0,0.0,0,C,1957,1958
Tony Curtale,2,0,0,0,0.0,0,D,1980,1981
Mike Vecchione,2,0,0,0,0.0,0,RW/C,2016,2017
David Pulkkinen,2,0,0,0,0.0,0,C,1972,1973
Dan Gloor,2,0,0,0,0.0,0,C,1973,1974
Bruce McIntosh,2,0,0,0,0.0,0,D,1972,1973
John McLellan,2,0,0,0,0.0,0,C,1951,1952
Andrew Poturalski,2,0,0,0,0.0,0,C/RW,2016,2017
Jim Jones,2,0,0,0,0.0,0,D,1971,1972
Justin Auger,2,0,0,0,0.0,0,RW,2017,2018
Steve Stone,2,0,0,0,0.0,0,RW,1973,1974
Vic Mercredi,2,0,0,0,0.0,0,LW,1974,1975
Jim McCrimmon,2,0,0,0,0.0,0,D,1974,1975
Christian Tanguay,2,0,0,0,0.0,0,RW,1981,1982
Jean Cusson,2,0,0,0,0.0,0,LW,1967,1968
Peter Folco,2,0,0,0,0.0,0,D,1973,1974
Don Wheldon,2,0,0,0,0.0,0,D,1974,1975
Anthony Richard,2,0,0,0,0.0,0,C/LW,2018,2020
Hub Anslow,2,0,0,0,0.0,0,LW,1947,1948
Bucky Buchanan,2,0,0,0,0.0,0,RW,1948,1949
Dominic Campedelli,2,0,0,0,0.0,0,D,1985,1986
"Billy Taylor, Jr.",2,0,0,0,0.0,0,C,1964,1965
Bob Jones,2,0,0,0,0.0,0,RW,1968,1969
Fred Bergdinon,2,0,0,0,0.0,0,RW,1925,1926
Max Sutherland,2,0,0,0,0.0,0,D,1931,1932
Otto Schmidt,2,0,0,0,0.0,0,LW,1943,1944
Ellard O'Brien,2,0,0,0,0.0,0,D,1955,1956
George Ranieri,2,0,0,0,0.0,0,LW,1956,1957
Pierre Gagne,2,0,0,0,0.0,0,LW,1959,1960
Scott McLellan,2,0,0,0,0.0,0,RW,1982,1983
Jocelyn Gauvreau,2,0,0,0,0.0,0,D,1983,1984
George Blair,2,0,0,0,0.0,0,C,1950,1951
Larry Gould,2,0,0,0,0.0,0,LW,1973,1974
Roland Rousseau,2,0,0,0,0.0,0,D,1952,1953
Pat Nolan,2,0,0,0,0.0,0,D/LW,1921,1922
Cliff McBride,2,0,0,0,0.0,0,RW,1928,1930
Andrei Chibisov,2,0,0,0,0.0,0,RW,2019,2020
Bruce Holloway,2,0,0,0,0.0,0,D,1984,1985
Jack Howard,2,0,0,0,0.0,0,D,1936,1937
Phil Samis,2,0,0,0,0.0,0,D,1947,1950
Wally Maxwell,2,0,0,0,0.0,0,C,1952,1953
Andre Champagne,2,0,0,0,0.0,0,LW,1962,1963
Dave Orleski,2,0,0,0,0.0,0,LW,1980,1982
Bob Sykes,2,0,0,0,0.0,0,LW,1974,1975
Jalen Chatfield,2,0,0,0,0.0,0,D,2020,2021
Hub Wilson,2,0,0,0,0.0,0,LW,1931,1932
Frank Beisler,2,0,0,0,0.0,0,D,1936,1940
Lloyd Finkbeiner,2,0,0,0,0.0,0,LW,1940,1941
Gord McFarlane,2,0,0,0,0.0,0,D,1926,1927
Rene Drolet,2,0,0,0,0.0,0,C,1971,1975
Tom Coulter,2,0,0,0,0.0,0,D,1933,1934
Glenn Johannesen,2,0,0,0,0.0,0,D/LW,1985,1986
Bob Frampton,2,0,0,0,0.0,0,LW,1949,1950
Geoff Powis,2,0,0,0,0.0,0,C/LW,1967,1968
Dwight Carruthers,2,0,0,0,0.0,0,D,1965,1968
Alexander Hudson,2,0,0,0,0.0,0,D,1978,1979
George Standing,2,0,0,0,0.0,0,RW,1967,1968
Jamie Gallimore,2,0,0,0,0.0,0,F,1977,1978
Wayne Ramsey,2,0,0,0,0.0,0,D,1977,1978
Ed Zeniuk,2,0,0,0,0.0,0,D,1954,1955
Dave Campbell,2,0,0,0,0.0,0,F,1920,1921
Jacques Deslauriers,2,0,0,0,0.0,0,D,1955,1956
Francis Kane,2,0,0,0,0.0,0,D,1943,1944
Gus Leroux,2,0,0,0,0.0,0,D,1935,1936
Walt McCartney,2,0,0,0,0.0,0,LW,1932,1933
Glen Smith,2,0,0,0,0.0,0,RW,1950,1951
Denis Chervyakov,2,0,0,0,0.0,2,D,1992,1993
Jared Staal,2,0,0,0,0.0,2,RW,2012,2013
Riley Armstrong,2,0,0,0,0.0,2,C/RW,2008,2009
Kris Chucko,2,0,0,0,0.0,2,LW/RW,2008,2009
Eric Healey,2,0,0,0,0.0,2,LW,2005,2006
Chris Allen,2,0,0,0,0.0,2,D,1997,1999
Brett Lysak,2,0,0,0,0.0,2,RW/C,2003,2004
Mike Connolly,2,0,0,0,0.0,2,LW,2011,2012
Dmitri Yakushin,2,0,0,0,0.0,2,D,1999,2000
Adam Payerl,2,0,0,0,0.0,2,C/RW,2013,2014
Brayden Irwin,2,0,0,0,0.0,2,C/RW,2009,2010
Andrew Crescenzi,2,0,0,0,0.0,2,C,2017,2018
Dale Dunbar,2,0,0,0,0.0,2,D,1985,1989
Melvin Angelstad,2,0,0,0,0.0,2,LW,2003,2004
Jeff Lank,2,0,0,0,0.0,2,D,1999,2000
Dave Reierson,2,0,0,0,0.0,2,D,1988,1989
Bob Babcock,2,0,0,0,0.0,2,D,1990,1993
Victor Posa,2,0,0,0,0.0,2,D,1985,1986
Alex Broadhurst,2,0,0,0,0.0,2,C,2017,2018
Dave Goertz,2,0,0,0,0.0,2,D,1987,1988
Justin Kloos,2,0,0,0,0.0,2,C/RW,2017,2019
Ron Serafini,2,0,0,0,0.0,2,D,1973,1974
Frank Bathgate,2,0,0,0,0.0,2,C,1952,1953
Sandy McGregor,2,0,0,0,0.0,2,RW,1963,1964
Gordon Turlick,2,0,0,0,0.0,2,C,1959,1960
Gordie Williams,2,0,0,0,0.0,2,RW,1981,1983
Jake Bean,2,0,0,0,0.0,2,D,2018,2021
Rudy Zunich,2,0,0,0,0.0,2,D,1943,1944
Jim Witherspoon,2,0,0,0,0.0,2,D,1975,1976
Drew Bagnall,2,0,0,0,0.0,4,D,2010,2011
Nick Stajduhar,2,0,0,0,0.0,4,D,1995,1996
Paxton Schulte,2,0,0,0,0.0,4,LW,1993,1997
Sean Williams,2,0,0,0,0.0,4,C,1991,1992
Glenn Mulvenna,2,0,0,0,0.0,4,C,1991,1993
Jim Mathieson,2,0,0,0,0.0,4,D,1989,1990
Kevin Primeau,2,0,0,0,0.0,4,RW,1980,1981
Herbert Hamel,2,0,0,0,0.0,4,RW,1930,1931
Bryon Baltimore,2,0,0,0,0.0,4,D,1979,1980
Hugh Jessiman,2,0,0,0,0.0,5,RW,2010,2011
Louis Robitaille,2,0,0,0,0.0,5,LW/D,2005,2006
Mark Major,2,0,0,0,0.0,5,LW,1996,1997
Bob Bergloff,2,0,0,0,0.0,5,D,1982,1983
Ed Lee,2,0,0,0,0.0,5,RW,1984,1985
Nikos Tselios,2,0,0,0,0.0,6,D,2001,2002
Ruslan Batyrshin,2,0,0,0,0.0,6,D,1995,1996
Jeff Paul,2,0,0,0,0.0,7,D,2002,2003
Justin Johnson,2,0,0,0,0.0,7,RW,2013,2014
Mitch Molloy,2,0,0,0,0.0,10,LW,1989,1990
Darryl Williams,2,0,0,0,0.0,10,LW,1992,1993
Thomas Di Pauli,2,0,0,0,0.0,10,C/LW,2019,2020
Mike Vellucci,2,0,0,0,0.0,11,D,1987,1988
Marko Jantunen,3,0,0,0,0.0,0,LW,1996,1997
Roger Hagglund,3,0,0,0,0.0,0,D/C,1984,1985
Roger Melin,3,0,0,0,0.0,0,C,1980,1982
Ryan Savoia,3,0,0,0,0.0,0,C,1998,1999
Pierre-Claude Drouin,3,0,0,0,0.0,0,LW,1996,1997
Dale Clarke,3,0,0,0,0.0,0,D,2000,2001
Oskar Osala,3,0,0,0,0.0,0,LW/C,2008,2010
Petr Taticek,3,0,0,0,0.0,0,C,2005,2006
Bill Sweatt,3,0,0,0,0.0,0,LW,2011,2013
Adam Pineault,3,0,0,0,0.0,0,RW,2007,2008
Petr Mika,3,0,0,0,0.0,0,RW,1999,2000
Alex Foster,3,0,0,0,0.0,0,LW/C,2007,2008
Mike Stuart,3,0,0,0,0.0,0,D,2003,2006
Ryan Bonni,3,0,0,0,0.0,0,D,1999,2000
Alexander Nikulin,3,0,0,0,0.0,0,C,2007,2009
Colin Hemingway,3,0,0,0,0.0,0,RW,2005,2006
Mike Pandolfo,3,0,0,0,0.0,0,LW,2003,2004
Pat Cannone,3,0,0,0,0.0,0,C,2016,2017
Nicolas Deschamps,3,0,0,0,0.0,0,W/C,2013,2014
Alexander Volchkov,3,0,0,0,0.0,0,C,1999,2000
Yuri Babenko,3,0,0,0,0.0,0,C/RW,2000,2001
John McFarland,3,0,0,0,0.0,0,LW/RW,2015,2016
Zac Boyer,3,0,0,0,0.0,0,RW,1994,1996
Brad Turner,3,0,0,0,0.0,0,D,1991,1992
Reg Abbott,3,0,0,0,0.0,0,C,1952,1953
Randy Smith,3,0,0,0,0.0,0,C,1985,1987
Dave Gorman,3,0,0,0,0.0,0,RW,1979,1980
Brian Wiseman,3,0,0,0,0.0,0,C,1996,1997
Mikhail Kuleshov,3,0,0,0,0.0,0,F,2003,2004
Ryan Hughes,3,0,0,0,0.0,0,C,1995,1996
Lee Sorochan,3,0,0,0,0.0,0,D,1998,2000
Craig Reichert,3,0,0,0,0.0,0,RW,1996,1997
Maxim Bets,3,0,0,0,0.0,0,LW,1993,1994
Duane Joyce,3,0,0,0,0.0,0,D,1993,1994
Roy Mitchell,3,0,0,0,0.0,0,D,1992,1993
Mike Casselman,3,0,0,0,0.0,0,C,1995,1996
Jaroslav Jirik,3,0,0,0,0.0,0,LW,1969,1970
Jim Camazzola,3,0,0,0,0.0,0,D,1983,1987
Ryan Mulhern,3,0,0,0,0.0,0,C,1997,1998
Fred Berry,3,0,0,0,0.0,0,C,1976,1977
Bo Elik,3,0,0,0,0.0,0,LW,1962,1963
Alexander Barabanov,3,0,0,0,0.0,0,RW,2020,2021
Nic Kerdiles,3,0,0,0,0.0,0,LW,2016,2018
Doug Brindley,3,0,0,0,0.0,0,C,1970,1971
Pete Vipond,3,0,0,0,0.0,0,LW,1972,1973
Michel Archambault,3,0,0,0,0.0,0,LW,1976,1977
Serge Beaudoin,3,0,0,0,0.0,0,D,1979,1980
Yves Bergeron,3,0,0,0,0.0,0,RW,1974,1977
Lou Nistico,3,0,0,0,0.0,0,LW,1977,1978
Brandon Hagel,3,0,0,0,0.0,0,LW,2019,2021
Brent Imlach,3,0,0,0,0.0,0,LW,1965,1967
Fern Perreault,3,0,0,0,0.0,0,LW,1947,1950
Mike Labadie,3,0,0,0,0.0,0,RW,1952,1953
Art Chisholm,3,0,0,0,0.0,0,C,1960,1961
Calvin Thurkauf,3,0,0,0,0.0,0,C/LW,2019,2020
Blake Speers,3,0,0,0,0.0,0,C/RW,2016,2017
Thain Simon,3,0,0,0,0.0,0,D,1946,1947
Gord Spence,3,0,0,0,0.0,0,LW,1925,1926
Grant Sasser,3,0,0,0,0.0,0,C,1983,1984
Robert Richer,3,0,0,0,0.0,0,C,1972,1973
Michael Toal,3,0,0,0,0.0,0,C,1979,1980
Beck Malenstyn,3,0,0,0,0.0,0,LW,2019,2020
Butch Paul,3,0,0,0,0.0,0,C,1964,1965
Steve Self,3,0,0,0,0.0,0,C,1976,1977
Bob Davis,3,0,0,0,0.0,0,RW,1932,1933
Doug Lewis,3,0,0,0,0.0,0,LW,1946,1947
Cliff Malone,3,0,0,0,0.0,0,RW,1951,1952
Tobias Bjornfot,3,0,0,0,0.0,0,D,2019,2020
Per Ledin,3,0,0,0,0.0,2,LW,2008,2009
Marcel Muller,3,0,0,0,0.0,2,LW/C,2010,2011
Patrice Lefebvre,3,0,0,0,0.0,2,LW,1998,1999
Matt Koalska,3,0,0,0,0.0,2,C,2005,2006
Goran Bezina,3,0,0,0,0.0,2,D,2003,2004
Justin Shugg,3,0,0,0,0.0,2,RW/LW,2014,2015
Kris Fredheim,3,0,0,0,0.0,2,D,2011,2012
Gaetan Royer,3,0,0,0,0.0,2,RW,2001,2002
Jason Cirone,3,0,0,0,0.0,2,C,1991,1992
David Wolf,3,0,0,0,0.0,2,LW/RW,2014,2015
Lloyd Ailsby,3,0,0,0,0.0,2,D,1951,1952
Henrik Samuelsson,3,0,0,0,0.0,2,C/RW,2014,2015
Morgan Ellis,3,0,0,0,0.0,2,D,2015,2016
Tanner Richard,3,0,0,0,0.0,2,C,2016,2017
Dillon Simpson,3,0,0,0,0.0,2,D,2016,2017
Benoit Dusablon,3,0,0,0,0.0,2,C,2003,2004
Matt Glennon,3,0,0,0,0.0,2,LW,1991,1992
Travis Richards,3,0,0,0,0.0,2,D,1994,1996
Luc Gauthier,3,0,0,0,0.0,2,D,1990,1991
Chad Penney,3,0,0,0,0.0,2,LW,1993,1994
Kevin Krook,3,0,0,0,0.0,2,D,1978,1979
Tim Harrer,3,0,0,0,0.0,2,RW,1982,1983
Steve Lyon,3,0,0,0,0.0,2,RW,1976,1977
Ian McKegney,3,0,0,0,0.0,2,D,1976,1977
Josh Jacobs,3,0,0,0,0.0,2,D,2018,2020
Marty Lauder,3,0,0,0,0.0,2,C,1927,1928
Ray Hannigan,3,0,0,0,0.0,2,RW,1948,1949
Jerry Wilson,3,0,0,0,0.0,2,F,1956,1957
Randy Murray,3,0,0,0,0.0,2,D,1969,1970
Harvie Pocza,3,0,0,0,0.0,2,LW,1979,1982
Joachim Blichfeld,3,0,0,0,0.0,2,RW/LW,2019,2020
Logan Stanley,3,0,0,0,0.0,2,D,2020,2021
Adie Lafrance,3,0,0,0,0.0,2,LW,1933,1934
Sandy Snow,3,0,0,0,0.0,2,RW,1968,1969
Ross Lupaschuk,3,0,0,0,0.0,4,D,2002,2003
Mathieu Carle,3,0,0,0,0.0,4,D,2009,2010
Trevor Frischmon,3,0,0,0,0.0,4,C,2009,2010
Colby Cohen,3,0,0,0,0.0,4,D,2010,2011
Mike Gaul,3,0,0,0,0.0,4,D,1998,2001
Ben Thomson,3,0,0,0,0.0,4,LW,2016,2017
Kevin Kemp,3,0,0,0,0.0,4,D,1980,1981
Tony Camazzola,3,0,0,0,0.0,4,D,1981,1982
Joe Bretto,3,0,0,0,0.0,4,D,1944,1945
Grant McNeill,3,0,0,0,0.0,5,D,2003,2004
Steven Fletcher,3,0,0,0,0.0,5,D,1987,1989
Brian Johnson,3,0,0,0,0.0,5,C,1983,1984
Dennis McCord,3,0,0,0,0.0,6,D,1973,1974
Shayne Toporowski,3,0,0,0,0.0,7,RW,1996,1997
Alan Hepple,3,0,0,0,0.0,7,D,1983,1986
John Arundel,3,0,0,0,0.0,9,D,1949,1950
Gord Nelson,3,0,0,0,0.0,11,D,1969,1970
Dave Allison,3,0,0,0,0.0,12,D,1983,1984
Bobby Robins,3,0,0,0,0.0,14,RW,2014,2015
Garret Stroshein,3,0,0,0,0.0,14,RW,2003,2004
Brian Chapman,3,0,0,0,0.0,29,D,1990,1991
Ulf Sterner,4,0,0,0,0.0,0,C,1964,1965
Philippe Audet,4,0,0,0,0.0,0,LW,1998,1999
Linus Klasen,4,0,0,0,0.0,0,LW,2010,2011
Brian Watts,4,0,0,0,0.0,0,LW,1975,1976
Mike Card,4,0,0,0,0.0,0,D,2006,2007
Carsen Germyn,4,0,0,0,0.0,0,RW,2005,2007
Evan Brophey,4,0,0,0,0.0,0,C/LW,2010,2012
Kyle Greentree,4,0,0,0,0.0,0,LW,2007,2009
Jeff MacMillan,4,0,0,0,0.0,0,D,2003,2004
Ravil Gusmanov,4,0,0,0,0.0,0,LW,1995,1996
Kim Issel,4,0,0,0,0.0,0,RW,1988,1989
Matt Lindblad,4,0,0,0,0.0,0,C/LW,2013,2015
Scott Morrow,4,0,0,0,0.0,0,LW,1994,1995
Bruce Major,4,0,0,0,0.0,0,C,1990,1991
Keith Aldridge,4,0,0,0,0.0,0,D,1999,2000
Patrik Augusta,4,0,0,0,0.0,0,LW,1993,1999
Albert Pudas,4,0,0,0,0.0,0,F,1926,1927
Justin Duberman,4,0,0,0,0.0,0,RW,1993,1994
Henry Lehvonen,4,0,0,0,0.0,0,D,1974,1975
Mike Natyshak,4,0,0,0,0.0,0,F,1987,1988
Stephen MacNeil,4,0,0,0,0.0,0,C,1973,1974
Chase De Leo,4,0,0,0,0.0,0,C/LW,2015,2020
Dale Smedsmo,4,0,0,0,0.0,0,LW,1972,1973
Jim Mayer,4,0,0,0,0.0,0,RW,1979,1980
Ron Howell,4,0,0,0,0.0,0,D,1954,1956
Wayne Hall,4,0,0,0,0.0,0,LW,1960,1961
Harry Frost,4,0,0,0,0.0,0,RW,1938,1939
Ted Hodgson,4,0,0,0,0.0,0,RW,1966,1967
Cecil Hoekstra,4,0,0,0,0.0,0,LW,1959,1960
George O'Grady,4,0,0,0,0.0,0,D,1917,1918
Bobby Walton,4,0,0,0,0.0,0,RW,1943,1944
Andre Hinse,4,0,0,0,0.0,0,LW,1967,1968
Bert Burry,4,0,0,0,0.0,0,D,1932,1933
Joe Thorsteinson,4,0,0,0,0.0,0,RW,1932,1933
William Borgen,4,0,0,0,0.0,0,D,2018,2021
George Pargeter,4,0,0,0,0.0,0,LW,1946,1947
Bill Lecaine,4,0,0,0,0.0,0,LW,1968,1969
Vern Stenlund,4,0,0,0,0.0,0,F,1976,1977
Ron Areshenkoff,4,0,0,0,0.0,0,C,1979,1980
Alexander Yelesin,4,0,0,0,0.0,0,D,2019,2020
Danil Yurtaikin,4,0,0,0,0.0,0,LW,2019,2020
Dennis Olson,4,0,0,0,0.0,0,C,1957,1958
Hugh Millar,4,0,0,0,0.0,0,D,1946,1947
German Rubtsov,4,0,0,0,0.0,0,C,2019,2020
Harri Pesonen,4,0,0,0,0.0,2,LW,2012,2013
Jeff Zehr,4,0,0,0,0.0,2,LW,1999,2000
Connor Jones,4,0,0,0,0.0,2,C/LW,2016,2017
Rick Adduono,4,0,0,0,0.0,2,C,1975,1980
Jeff Allan,4,0,0,0,0.0,2,D,1977,1978
Doug Barrault,4,0,0,0,0.0,2,RW,1992,1994
Olexander Vasilevski,4,0,0,0,0.0,2,RW,1995,1997
Robb Gordon,4,0,0,0,0.0,2,C,1998,1999
Steve Seftel,4,0,0,0,0.0,2,LW,1990,1991
Todd Okerlund,4,0,0,0,0.0,2,RW,1987,1988
Conley Forey,4,0,0,0,0.0,2,LW,1973,1974
Gord Buynak,4,0,0,0,0.0,2,D,1974,1975
Bill McDonagh,4,0,0,0,0.0,2,LW,1949,1950
Phil Latreille,4,0,0,0,0.0,2,F,1960,1961
Joe Ward,4,0,0,0,0.0,2,C,1980,1981
Charles Shannon,4,0,0,0,0.0,2,D,1939,1940
Fred Burchell,4,0,0,0,0.0,2,C,1950,1954
Glen Cressman,4,0,0,0,0.0,2,C,1956,1957
Ernest Roche,4,0,0,0,0.0,2,D,1950,1951
Alexis Lafreniere,4,0,0,0,0.0,2,LW,2020,2021
Ryan Caldwell,4,0,0,0,0.0,4,D,2005,2008
Anton Wedin,4,0,0,0,0.0,4,LW/RW,2019,2020
David Struch,4,0,0,0,0.0,4,C,1993,1994
Ian MacIntosh,4,0,0,0,0.0,4,LW,1952,1953
Jake Bischoff,4,0,0,0,0.0,4,D,2019,2020
Randy Johnston,4,0,0,0,0.0,4,D,1979,1980
Ryan Tobler,4,0,0,0,0.0,5,LW,2001,2002
David Morisset,4,0,0,0,0.0,5,RW,2001,2002
Rick Hayward,4,0,0,0,0.0,5,D,1990,1991
Gary Geldart,4,0,0,0,0.0,5,D,1970,1971
Gord Hampson,4,0,0,0,0.0,5,F,1982,1983
Perry Pelensky,4,0,0,0,0.0,5,RW,1983,1984
Mike Meeker,4,0,0,0,0.0,5,C,1978,1979
Keegan Lowe,4,0,0,0,0.0,10,D,2014,2018
Frank Bialowas,4,0,0,0,0.0,12,LW,1993,1994
Geordie Kinnear,4,0,0,0,0.0,13,D,1999,2000
Brett Gallant,4,0,0,0,0.0,17,LW,2013,2014
Jamie Linden,4,0,0,0,0.0,17,RW,1994,1995
Jason MacDonald,4,0,0,0,0.0,19,RW,2003,2004
Bob Bodak,4,0,0,0,0.0,29,LW,1987,1990
Tom Bissett,5,0,0,0,0.0,0,LW,1990,1991
Christer Kellgren,5,0,0,0,0.0,0,RW,1981,1982
Peter Ciavaglia,5,0,0,0,0.0,0,C,1991,1993
Lauri Tukonen,5,0,0,0,0.0,0,RW/LW,2006,2008
Jonathan Filewich,5,0,0,0,0.0,0,RW,2007,2008
Vojtech Polak,5,0,0,0,0.0,0,W/C,2005,2007
Bob Wren,5,0,0,0,0.0,0,C,1997,2002
Aaron MacKenzie,5,0,0,0,0.0,0,D,2008,2009
Thomas Ziegler,5,0,0,0,0.0,0,C,2000,2001
Jon Rheault,5,0,0,0,0.0,0,RW/C,2012,2013
Daniel Gauthier,5,0,0,0,0.0,0,C,1994,1995
Steve Junker,5,0,0,0,0.0,0,LW/C,1992,1994
Patrick Holland,5,0,0,0,0.0,0,RW/C,2013,2014
George Servinis,5,0,0,0,0.0,0,LW,1987,1988
John Johannson,5,0,0,0,0.0,0,F,1983,1984
Mitch Callahan,5,0,0,0,0.0,0,RW,2013,2017
Mario Thyer,5,0,0,0,0.0,0,C,1989,1990
Bill Terry,5,0,0,0,0.0,0,C,1987,1988
Terry Virtue,5,0,0,0,0.0,0,D,1998,2000
Kyle Baun,5,0,0,0,0.0,0,RW,2014,2016
Frank Hughes,5,0,0,0,0.0,0,RW,1971,1972
Michael Kapla,5,0,0,0,0.0,0,D,2016,2017
Otto Leskinen,5,0,0,0,0.0,0,D,2019,2020
Sammy McAdam,5,0,0,0,0.0,0,D,1930,1931
Ron Buchanan,5,0,0,0,0.0,0,C,1966,1970
Arthur Michaluk,5,0,0,0,0.0,0,D,1947,1948
Olli Juolevi,5,0,0,0,0.0,0,D,2019,2021
Griffen Molino,5,0,0,0,0.0,0,C/LW,2016,2017
Aubrey Webster,5,0,0,0,0.0,0,RW,1930,1935
Art Townsend,5,0,0,0,0.0,0,D,1926,1927
Ed Vokes,5,0,0,0,0.0,0,RW,1930,1931
Gregory Vaydik,5,0,0,0,0.0,0,C,1976,1977
Milt Brink,5,0,0,0,0.0,0,C,1936,1937
Patrick Clark,5,0,0,0,0.0,0,D,1927,1928
Frank Daley,5,0,0,0,0.0,0,LW,1928,1929
Al Suomi,5,0,0,0,0.0,0,LW,1936,1937
Aleksandrs Kercs,5,0,0,0,0.0,2,LW,1993,1994
Doug O'Brien,5,0,0,0,0.0,2,D,2005,2006
Brad Leeb,5,0,0,0,0.0,2,RW,1999,2004
Charles Linglet,5,0,0,0,0.0,2,LW,2009,2010
Kevin Wortman,5,0,0,0,0.0,2,D,1993,1994
Jake Chelios,5,0,0,0,0.0,2,D,2018,2019
Mathias Brome,5,0,0,0,0.0,2,LW/RW,2020,2021
Alexandre Carrier,5,0,0,0,0.0,2,D,2016,2020
Dean Jenkins,5,0,0,0,0.0,2,RW,1983,1984
Kole Sherwood,5,0,0,0,0.0,2,RW,2018,2020
Brennan Menell,5,0,0,0,0.0,2,D,2019,2020
Jean-Guy Trudel,5,0,0,0,0.0,4,LW,1999,2003
Richard Hajdu,5,0,0,0,0.0,4,RW,1985,1987
Brady Austin,5,0,0,0,0.0,4,D,2016,2017
Paul Jerrard,5,0,0,0,0.0,4,D/RW,1988,1989
Doc Prentice,5,0,0,0,0.0,4,LW,1943,1944
Max Labovitch,5,0,0,0,0.0,4,F,1943,1944
Ted Lanyon,5,0,0,0,0.0,4,D,1967,1968
John Hendrickson,5,0,0,0,0.0,4,D,1957,1962
Guy Gosselin,5,0,0,0,0.0,6,D,1987,1988
Wes O'Neill,5,0,0,0,0.0,6,D,2008,2010
Wally Clune,5,0,0,0,0.0,6,D,1955,1956
Butch Schaeffer,5,0,0,0,0.0,6,D,1936,1937
Steve Seguin,5,0,0,0,0.0,9,RW,1984,1985
John Craighead,5,0,0,0,0.0,10,RW,1996,1997
Shawn Byram,5,0,0,0,0.0,14,LW,1990,1992
Rocky Dundas,5,0,0,0,0.0,14,RW,1989,1990
Mario Larocque,5,0,0,0,0.0,16,D,1998,1999
Jacques Mailhot,5,0,0,0,0.0,33,RW,1988,1989
Jason Simon,5,0,0,0,0.0,34,LW,1993,1997
Ryan Keller,6,0,0,0,0.0,0,RW,2009,2010
Maxim Noreau,6,0,0,0,0.0,0,D,2009,2011
Jason Miller,6,0,0,0,0.0,0,C,1990,1993
Jack Capuano,6,0,0,0,0.0,0,D,1989,1992
Kirk Nielsen,6,0,0,0,0.0,0,RW,1997,1998
Jakub Zboril,6,0,0,0,0.0,0,D,2018,2021
Paul O'Neil,6,0,0,0,0.0,0,C,1973,1976
Conrad Bourcier,6,0,0,0,0.0,0,C,1935,1936
Charles Larose,6,0,0,0,0.0,0,F,1925,1926
Ellis Pringle,6,0,0,0,0.0,0,D,1930,1931
Cooper Marody,6,0,0,0,0.0,0,C,2018,2019
Rick Newell,6,0,0,0,0.0,0,D,1972,1974
Conor Timmins,6,0,0,0,0.0,0,D,2019,2021
Chris Hajt,6,0,0,0,0.0,2,D,2000,2004
Max Friberg,6,0,0,0,0.0,2,RW,2014,2016
David Gans,6,0,0,0,0.0,2,C,1982,1986
Bryce Van Brabant,6,0,0,0,0.0,2,LW/C,2013,2014
Ken Yackel,6,0,0,0,0.0,2,RW,1958,1959
Walter Harnott,6,0,0,0,0.0,2,LW,1933,1934
Ed Stankiewicz,6,0,0,0,0.0,2,RW,1953,1956
Steve Short,6,0,0,0,0.0,2,D,1977,1979
Don MacIver,6,0,0,0,0.0,2,D,1979,1980
Leo Murray,6,0,0,0,0.0,2,C,1932,1933
Jon DiSalvatore,6,0,0,0,0.0,4,RW,2005,2012
Jaroslav Kristek,6,0,0,0,0.0,4,C/RW,2002,2003
Rasmus Rissanen,6,0,0,0,0.0,4,D,2014,2015
Petteri Lehto,6,0,0,0,0.0,4,D,1984,1985
Mark Cornforth,6,0,0,0,0.0,4,D,1995,1996
Mike Matteucci,6,0,0,0,0.0,4,D,2000,2002
Rick Hodgson,6,0,0,0,0.0,6,D,1979,1980
Jeff Buchanan,6,0,0,0,0.0,6,D,1998,1999
Kale Clague,6,0,0,0,0.0,6,D,2019,2021
Libor Sulak,6,0,0,0,0.0,6,D,2018,2019
Floyd Hillman,6,0,0,0,0.0,10,D,1956,1957
Tom Manastersky,6,0,0,0,0.0,11,D,1950,1951
Mike MacWilliam,6,0,0,0,0.0,14,LW,1995,1996
Gavin Morgan,6,0,0,0,0.0,21,C,2003,2004
James Boo,6,0,0,0,0.0,22,D,1977,1978
Andrew Rymsha,6,0,0,0,0.0,23,RW,1991,1992
Steve McLaren,6,0,0,0,0.0,25,LW,2003,2004
Janne Pesonen,7,0,0,0,0.0,0,LW/C,2008,2009
Ilkka Heikkinen,7,0,0,0,0.0,0,D,2009,2010
Sylvain Cloutier,7,0,0,0,0.0,0,C,1998,1999
Roman Wick,7,0,0,0,0.0,0,LW/RW,2010,2011
Craig Sarner,7,0,0,0,0.0,0,LW/C,1974,1975
Evan Oberg,7,0,0,0,0.0,0,D,2009,2012
Claude Noel,7,0,0,0,0.0,0,C,1979,1980
Ryan Christie,7,0,0,0,0.0,0,LW,1999,2002
Maynard Schurman,7,0,0,0,0.0,0,LW,1979,1980
Sheldon Rempal,7,0,0,0,0.0,0,RW/LW,2018,2019
Art Strobel,7,0,0,0,0.0,0,LW,1943,1944
John Brackenborough,7,0,0,0,0.0,0,LW,1925,1926
Urho Vaakanainen,7,0,0,0,0.0,0,D,2018,2021
Rene Boileau,7,0,0,0,0.0,0,C,1925,1926
Benjamin LaPrairie,7,0,0,0,0.0,0,D,1936,1937
Jaroslav Obsut,7,0,0,0,0.0,2,D,2000,2002
Rhett Rakhshani,7,0,0,0,0.0,2,RW/LW,2010,2012
Graham Mink,7,0,0,0,0.0,2,RW,2003,2009
Nathan Robinson,7,0,0,0,0.0,2,RW/C,2003,2006
Peter Lappin,7,0,0,0,0.0,2,RW,1989,1992
Terry Hollinger,7,0,0,0,0.0,2,D,1993,1995
Stan Baluik,7,0,0,0,0.0,2,C,1959,1960
Brent Regner,7,0,0,0,0.0,4,D,2015,2016
Conor Allen,7,0,0,0,0.0,4,D,2013,2015
Vojtech Mozik,7,0,0,0,0.0,4,D,2015,2016
Jack Marks,7,0,0,0,0.0,4,LW,1917,1920
Dean Magee,7,0,0,0,0.0,4,F,1977,1978
Emil Hanson,7,0,0,0,0.0,6,D,1932,1933
Ben Holmstrom,7,0,0,0,0.0,7,C,2010,2012
Brendan Woods,7,0,0,0,0.0,7,LW/C,2014,2016
Jeff Mitchell,7,0,0,0,0.0,7,C,1997,1998
Stefan Bergqvist,7,0,0,0,0.0,9,D,1995,1997
Stefan Della Rovere,7,0,0,0,0.0,11,LW,2010,2011
Trevor Carrick,7,0,0,0,0.0,12,D,2015,2020
Scott Shaunessy,7,0,0,0,0.0,23,D,1986,1989
Benoit Gosselin,7,0,0,0,0.0,33,LW,1977,1978
Simo Saarinen,8,0,0,0,0.0,0,D,1984,1985
Jakub Cutta,8,0,0,0,0.0,0,D,2000,2004
Yann Sauve,8,0,0,0,0.0,0,D,2010,2014
Chase Balisy,8,0,0,0,0.0,0,C/RW,2017,2018
MacGregor Sharp,8,0,0,0,0.0,0,C/LW,2009,2010
Mitch Babin,8,0,0,0,0.0,0,C,1975,1976
Mike Posavad,8,0,0,0,0.0,0,D,1985,1987
Dale Lewis,8,0,0,0,0.0,0,LW,1975,1976
Oscar Hanson,8,0,0,0,0.0,0,C,1937,1938
Gene Chouinard,8,0,0,0,0.0,0,D,1927,1928
Guillaume Brisebois,8,0,0,0,0.0,0,D,2018,2019
Bob Hall,8,0,0,0,0.0,0,F,1925,1926
Fredrik Bremberg,8,0,0,0,0.0,2,LW,1998,1999
Jason Ryznar,8,0,0,0,0.0,2,LW,2005,2006
Gabe Gauthier,8,0,0,0,0.0,2,C,2006,2008
Paul Manning,8,0,0,0,0.0,2,D,2002,2003
Rhett Gardner,8,0,0,0,0.0,2,C/LW,2019,2021
Fred McLean,8,0,0,0,0.0,2,D,1919,1921
Hal Cooper,8,0,0,0,0.0,2,RW,1944,1945
Frank Sullivan,8,0,0,0,0.0,2,D,1949,1956
Lloyd Haddon,8,0,0,0,0.0,2,D,1959,1960
Nikolai Knyzhov,8,0,0,0,0.0,2,D,2019,2021
Harijs Vitolins,8,0,0,0,0.0,4,C,1993,1994
Dennis Smith,8,0,0,0,0.0,4,D,1989,1991
Greg Britz,8,0,0,0,0.0,4,C,1983,1987
Gerry McDonald,8,0,0,0,0.0,4,D,1981,1984
Emory Sparrow,8,0,0,0,0.0,4,F,1924,1925
Terran Sandwith,8,0,0,0,0.0,6,D,1997,1998
Bob Taylor,8,0,0,0,0.0,6,RW,1929,1930
Gerry Rioux,8,0,0,0,0.0,6,RW,1979,1980
Peter Allen,8,0,0,0,0.0,8,D,1995,1996
Jean-Marc Routhier,8,0,0,0,0.0,9,RW,1989,1990
Gordon Sherritt,8,0,0,0,0.0,12,D,1943,1944
Jay Johnston,8,0,0,0,0.0,13,D,1980,1982
Barry Nieckar,8,0,0,0,0.0,21,LW,1992,1998
Terry Ryan,8,0,0,0,0.0,36,C,1996,1999
Jason McBain,9,0,0,0,0.0,0,D,1995,1997
Mike Stutzel,9,0,0,0,0.0,0,LW,2003,2004
Andre Peloffy,9,0,0,0,0.0,0,C,1974,1975
William Lagesson,9,0,0,0,0.0,0,D,2019,2021
Ron Hutchinson,9,0,0,0,0.0,0,C,1960,1961
Glenn Smith,9,0,0,0,0.0,0,F,1921,1922
Jonas Andersson,9,0,0,0,0.0,2,RW/LW,2001,2011
Dan Jancevski,9,0,0,0,0.0,2,D,2005,2009
Alexander Khokhlachev,9,0,0,0,0.0,2,C/W,2013,2016
Alexandre Grenier,9,0,0,0,0.0,2,RW/C,2015,2017
Larry Landon,9,0,0,0,0.0,2,LW,1983,1985
Ladislav Karabin,9,0,0,0,0.0,2,LW,1993,1994
Dominic Turgeon,9,0,0,0,0.0,2,C,2017,2019
Guyle Fielder,9,0,0,0,0.0,2,C,1950,1958
Horace Merrill,9,0,0,0,0.0,3,D,1917,1920
Kyle Criscuolo,9,0,0,0,0.0,4,C,2017,2018
Paul Messier,9,0,0,0,0.0,4,C,1978,1979
Oliver Wahlstrom,9,0,0,0,0.0,4,RW,2019,2020
Jame Pollock,9,0,0,0,0.0,6,D,2003,2004
Don McLean,9,0,0,0,0.0,6,D,1975,1976
John Wilkinson,9,0,0,0,0.0,6,F,1943,1944
Colton White,9,0,0,0,0.0,6,D,2018,2020
Tony Tuzzolino,9,0,0,0,0.0,7,RW,1997,2002
Dean Melanson,9,0,0,0,0.0,8,D,1994,2002
Jeff Rohlicek,9,0,0,0,0.0,8,C,1987,1989
Samuel Morin,9,0,0,0,0.0,8,D/LW,2016,2021
Alex Tidey,9,0,0,0,0.0,8,RW,1976,1980
Nicolas Blanchard,9,0,0,0,0.0,20,LW,2012,2013
Serge Roberge,9,0,0,0,0.0,24,RW,1990,1991
Marc Labelle,9,0,0,0,0.0,46,LW,1996,1997
Greg Moore,10,0,0,0,0.0,0,RW,2007,2010
Steven Zalewski,10,0,0,0,0.0,0,C/LW,2009,2012
Paul Beraldo,10,0,0,0,0.0,0,RW,1987,1989
Gord Buttrey,10,0,0,0,0.0,0,LW,1943,1944
Ryan Kuffner,10,0,0,0,0.0,0,LW,2018,2019
Gordie Poirier,10,0,0,0,0.0,0,C,1939,1940
Bryce Lampman,10,0,0,0,0.0,2,D,2003,2007
Barrett Heisten,10,0,0,0,0.0,2,LW,2001,2002
Jack Rodewald,10,0,0,0,0.0,2,RW,2017,2019
Ryan Johnston,10,0,0,0,0.0,4,D,2015,2017
Francis Wathier,10,0,0,0,0.0,5,LW,2009,2013
Michel Bolduc,10,0,0,0,0.0,6,D,1981,1983
Kevin Marshall,10,0,0,0,0.0,8,D,2011,2012
Andrew Schneider,10,0,0,0,0.0,15,LW,1993,1994
Alexander Boikov,10,0,0,0,0.0,15,D,1999,2001
Todd Hawkins,10,0,0,0,0.0,15,LW,1988,1992
Kevin Schamehorn,10,0,0,0,0.0,17,RW,1976,1981
Ernie Kenny,10,0,0,0,0.0,18,D,1930,1935
Richard Scott,10,0,0,0,0.0,28,LW,2001,2004
Francis Belanger,10,0,0,0,0.0,29,LW,2000,2001
Radek Hamr,11,0,0,0,0.0,0,D,1992,1994
Brad Tiley,11,0,0,0,0.0,0,D,1997,2001
Greg Holst,11,0,0,0,0.0,0,C,1975,1978
Tyrell Goulbourne,11,0,0,0,0.0,2,LW/RW,2017,2019
Brett Skinner,11,0,0,0,0.0,4,D,2008,2009
Derek Bekar,11,0,0,0,0.0,4,C/LW,1999,2004
Yves Beaudoin,11,0,0,0,0.0,5,D,1985,1988
Nelson Nogier,11,0,0,0,0.0,5,D,2016,2021
Fred Sasakamoose,11,0,0,0,0.0,6,C,1953,1954
Skene Ronan,11,0,0,0,0.0,6,C,1918,1919
Mike Hordy,11,0,0,0,0.0,7,D,1978,1980
Mike Rowe,11,0,0,0,0.0,11,D,1984,1987
Val James,11,0,0,0,0.0,30,LW,1981,1987
Gerry Fleming,11,0,0,0,0.0,42,LW,1993,1995
Dave Morissette,11,0,0,0,0.0,57,LW,1998,2000
Brian Bonin,12,0,0,0,0.0,0,C,1998,2001
Brody Sutter,12,0,0,0,0.0,0,C/RW,2014,2016
Daniel Catenacci,12,0,0,0,0.0,0,C/LW,2015,2018
Bob Blake,12,0,0,0,0.0,0,LW,1935,1936
Craig Fisher,12,0,0,0,0.0,2,C,1989,1997
Riley Barber,12,0,0,0,0.0,2,RW,2016,2020
Rinat Valiyev,12,0,0,0,0.0,2,D,2015,2018
Otto Koivula,12,0,0,0,0.0,2,LW/C,2019,2020
Bill Folk,12,0,0,0,0.0,4,D,1951,1953
Nick Drazenovic,12,0,0,0,0.0,6,C,2010,2014
Peter Laviolette,12,0,0,0,0.0,6,D,1988,1989
Jim Dobson,12,0,0,0,0.0,6,RW,1979,1984
Pavel Skrbek,12,0,0,0,0.0,8,D,1998,2002
Edward Diachuk,12,0,0,0,0.0,19,LW,1960,1961
Brian McDonald,12,0,0,0,0.0,29,C,1967,1971
Art Gauthier,13,0,0,0,0.0,0,C,1926,1927
Philip Samuelsson,13,0,0,0,0.0,2,D,2013,2016
Jared Ross,13,0,0,0,0.0,2,C/LW,2008,2010
Mike Farrell,13,0,0,0,0.0,2,D/RW,2001,2004
Ted Stackhouse,13,0,0,0,0.0,2,D,1921,1922
David Printz,13,0,0,0,0.0,4,D,2005,2007
Kari Haakana,13,0,0,0,0.0,4,D,2002,2003
Roger Lafreniere,13,0,0,0,0.0,4,D,1962,1973
Dale Anderson,13,0,0,0,0.0,6,D,1956,1957
Hap Myers,13,0,0,0,0.0,6,D,1970,1971
Joe Piskula,13,0,0,0,0.0,10,D,2006,2015
Andrei Pedan,13,0,0,0,0.0,18,D,2015,2016
Joseph LaBate,13,0,0,0,0.0,21,LW,2016,2017
Dean Arsene,13,0,0,0,0.0,41,D,2009,2010
Terry Caffery,14,0,0,0,0.0,0,C,1969,1971
Chris Speyer,14,0,0,0,0.0,0,D,1923,1934
Ray Kinsella,14,0,0,0,0.0,0,LW,1930,1931
Derek Peltier,14,0,0,0,0.0,2,D,2008,2010
Alan Letang,14,0,0,0,0.0,2,D,1999,2003
Radoslav Hecl,14,0,0,0,0.0,2,D,2002,2003
Wilf Loughlin,14,0,0,0,0.0,2,D,1923,1924
John Webster,14,0,0,0,0.0,4,C,1949,1950
Dan Hinton,14,0,0,0,0.0,16,LW,1976,1977
Ty Jones,14,0,0,0,0.0,19,LW,1998,2004
Marc Laforge,14,0,0,0,0.0,64,D,1989,1994
Nick Smith,15,0,0,0,0.0,0,C,2001,2002
Andy Bellemer,15,0,0,0,0.0,0,D,1932,1933
Andreas Engqvist,15,0,0,0,0.0,4,C,2010,2012
Eric Bertrand,15,0,0,0,0.0,4,LW,1999,2001
Ray Cote,15,0,0,0,0.0,4,C,1982,1985
Mike Prokopec,15,0,0,0,0.0,11,RW,1995,1997
Jeff Harding,15,0,0,0,0.0,47,RW,1988,1990
Pascal Pelletier,16,0,0,0,0.0,0,LW/C,2007,2014
Ollie Reinikka,16,0,0,0,0.0,0,RW,1926,1927
Jesse Fibiger,16,0,0,0,0.0,2,D,2002,2003
Joona Luoto,16,0,0,0,0.0,2,LW/RW,2019,2020
Maurice Croghan,16,0,0,0,0.0,4,D,1937,1938
Billy Carter,16,0,0,0,0.0,6,C,1957,1962
Janne Kuokkanen,16,0,0,0,0.0,6,LW/C,2017,2021
Eddie Dorohoy,16,0,0,0,0.0,6,C,1948,1949
George Carroll,16,0,0,0,0.0,11,D,1924,1925
Jeff Batters,16,0,0,0,0.0,28,D,1993,1995
Kevin Colley,16,0,0,0,0.0,52,C/RW,2005,2006
Mike Baumgartner,17,0,0,0,0.0,0,D,1974,1975
Ernie Parkes,17,0,0,0,0.0,2,F,1924,1925
Jack Miller,17,0,0,0,0.0,4,C,1949,1951
Filip Novak,17,0,0,0,0.0,6,D,2005,2007
Charlie Phillips,17,0,0,0,0.0,6,D,1942,1943
Teemu Laakso,17,0,0,0,0.0,10,D,2009,2012
Bryan Young,17,0,0,0,0.0,10,D,2006,2008
Allan Egeland,17,0,0,0,0.0,16,C,1995,1998
John Morrison,18,0,0,0,0.0,0,F,1925,1926
Steven Fogarty,18,0,0,0,0.0,2,C/RW,2017,2020
Olivier Magnan,18,0,0,0,0.0,4,D,2010,2011
Jim Hofford,18,0,0,0,0.0,47,D,1985,1989
Remi Royer,18,0,0,0,0.0,67,D,1998,1999
Morris Titanic,19,0,0,0,0.0,0,LW,1974,1976
Mike Amodeo,19,0,0,0,0.0,2,D,1979,1980
Robbie Russo,19,0,0,0,0.0,2,D,2016,2017
Mark Alt,19,0,0,0,0.0,4,D,2014,2021
David Cullen,19,0,0,0,0.0,6,D,2000,2002
John Sherf,19,0,0,0,0.0,8,LW/D,1935,1944
Barry Boughner,20,0,0,0,0.0,11,LW,1969,1971
Mitch Fritz,20,0,0,0,0.0,42,LW,2008,2009
Stanley Crossett,21,0,0,0,0.0,10,D,1930,1931
Trent Frederic,21,0,0,0,0.0,15,C/LW,2018,2021
Sascha Goc,22,0,0,0,0.0,8,D,2000,2002
Dan Smith,22,0,0,0,0.0,16,D,1998,2006
Pavel Kolarik,23,0,0,0,0.0,10,D,2000,2002
Gord Kruppke,23,0,0,0,0.0,32,D,1990,1994
Guillaume Desbiens,23,0,0,0,0.0,37,RW/LW,2009,2012
Tomi Pettinen,24,0,0,0,0.0,18,D,2002,2006
Rocky Thompson,25,0,0,0,0.0,117,D/RW,1997,2002
Paul Higgins,25,0,0,0,0.0,152,RW,1981,1983
Werner Schnarr,26,0,0,0,0.0,0,C,1924,1926
Nathan Smith,26,0,0,0,0.0,14,C,2003,2010
Jack Duggan,27,0,0,0,0.0,0,LW,1925,1926
D'Arcy Coulson,28,0,0,0,0.0,103,D,1930,1931
Marc Moro,30,0,0,0,0.0,77,D,1997,2002
Rollie Paulhus,33,0,0,0,0.0,0,D,1925,1926
Reg Mackey,34,0,0,0,0.0,16,D,1926,1927
Stephane Guerard,34,0,0,0,0.0,40,D,1987,1990
Francis Callighen,36,0,0,0,0.0,32,D,1927,1928
Billy Cameron,39,0,0,0,0.0,2,RW,1923,1926
Frank Peters,43,0,0,0,0.0,59,D,1930,1931
Gord Strate,61,0,0,0,0.0,34,D,1956,1959
Marc Michaelis,0,0,0,0,0.0,0,LW/C,2020,2021
Brinson Pasichnuk,0,0,0,0,0.0,0,D,2020,2021
Bokondji Imama,0,0,0,0,0.0,0,LW,2020,2021
Artyom Zub,0,0,0,0,0.0,0,D,2020,2021
Wyatt Kalynuk,0,0,0,0,0.0,0,D,2020,2021
Alexander Chmelevski,0,0,0,0,0.0,0,C/RW,2020,2021
Dylan Samberg,0,0,0,0,0.0,0,D,2020,2021
Steven Lorentz,0,0,0,0,0.0,0,C/LW,2020,2021
Jeffrey Viel,0,0,0,0,0.0,0,LW,2020,2021
Nolan Foote,0,0,0,0,0.0,0,LW,2020,2021
Dylan Coghlan,0,0,0,0,0.0,0,D,2020,2021
Kevin Bahl,0,0,0,0,0.0,0,D,2020,2021
Reese Johnson,0,0,0,0,0.0,0,C/RW,2020,2021
Merv Kuryluk,0,0,0,0,0.0,0,LW,1961,1962
George McAvoy,0,0,0,0,0.0,0,D,1954,1955
Aleksi Heponiemi,0,0,0,0,0.0,0,C/RW,2020,2021
Samuel Fagemo,0,0,0,0,0.0,0,LW/RW,2020,2021
Marco Rossi,0,0,0,0,0.0,0,C,2020,2021
Jack Rathbone,0,0,0,0,0.0,0,D,2020,2021
Mikhail Maltsev,0,0,0,0,0.0,0,LW/C,2020,2021
Connor Mackey,0,0,0,0,0.0,0,D,2020,2021
Jack Quinn,0,0,0,0,0.0,0,RW/LW,2020,2021
Jonathan Aspirot,0,0,0,0,0.0,0,D/LW,2020,2021
Drew O'Connor,0,0,0,0,0.0,0,LW,2020,2021
Jake Neighbours,0,0,0,0,0.0,0,LW,2020,2021
Philip Tomasino,0,0,0,0,0.0,0,C,2020,2021
Connor McMichael,0,0,0,0,0.0,0,C,2020,2021
